Cuba	peso
Saba	dollar
Thailand	Baht
Paraguay	Guarani
Malawi	Kwacha
Finland	Euro
Portugal	Euro
Guinea	franc
Gibraltar	pound
Vietnam	dong
Nigeria	Naira
Georgia	Lari
Nepal	rupee
Mali	franc
Argentina	Peso
Liberia	dollar
Chile	Peso
Namibia	dollar
Kuwait	dinar
France	franc
Monaco	Euro
Nicaragua	cordoba
Gabon	franc
Syria	pound
Andorra	Euro
France	Euro
Seychelles	rupee
Bulgaria	Lev
Panama	balboa
Lebanon	pound
Panama	dollar
Zambia	kwacha
Afghanistan	Afghani
Congo	franc
Taiwan	dollar
Switzerland	franc
Djibouti	franc
Japan	Yen
Lithuania	litas
Norway	krone
Cyprus	Euro
Togo	franc
Australia	dollar
Chad	franc
Barbados	dollar
Niger	franc
Brazil	Real
Spain	Euro
Serbia	dinar
Austria	Euro
Mauritius	rupee
Brunei	dollar
Martinique	Euro
Bangladesh	Taka
Grenada	dollar
Malaysia	Ringgit
Denmark	krone
Greece	Euro
Algeria	Dinar
Laos	Kip
Singapore	dollar
Ecuador	dollar
Jordan	dinar
China	yuan
Greenland	Krone
Bermuda	dollar
Uganda	shilling
Comoros	franc
Montserrat	dollar
Zimbabwe	various
Tunisia	dinar
Belarus	ruble
Liechtenstein	franc
Tanzania	shilling
Germany	Euro
Somaliland	shilling
Indonesia	Rupiah
Turkey	lira
Bahrain	dinar
Colombia	Peso
Estonia	Euro
Netherlands	Euro
Kosovo	Euro
Croatia	Kuna
India	Rupee
Senegal	franc
Mexico	peso
Bahamas	dollar
Pakistan	Rupee
Malta	Euro
Belgium	Euro
Italy	Euro
Benin	franc
Peru	sol
Canada	dollar
Netherlands	dollar
Somalia	shilling
Cameroon	franc
Uruguay	peso
Philippines	Peso
Jamaica	dollar
Ireland	Euro
Sweden	krona
Reunion	Euro
Dominica	dollar
Suriname	dollar
Belize	dollar
Guyana	dollar
Iraq	dinar
Sudan	pound
Rwanda	franc
Slovakia	Euro
Libya	Dinar
Russia	ruble
China	Renminbi
Iceland	krona
Luxembourg	Euro
Montenegro	Euro
Kenya	shilling
