Abbeville	Alabama
Addison	Alabama
Akron	Alabama
Albertville	Alabama
Altoona	Alabama
Andalusia	Alabama
Anderson	Alabama
Anniston	Alabama
Arab	Alabama
Ardmore	Alabama
Ashford	Alabama
Ashland	Alabama
Athens	Alabama
Auburn	Alabama
Avon	Alabama
Banks	Alabama
Beatrice	Alabama
Beaverton	Alabama
Benton	Alabama
Berry	Alabama
Birmingham	Alabama
Black	Alabama
Brent	Alabama
Bridgeport	Alabama
Brighton	Alabama
Brilliant	Alabama
Brookside	Alabama
Butler	Alabama
Camden	Alabama
Cardiff	Alabama
Carolina	Alabama
Carrollton	Alabama
Centre	Alabama
Chelsea	Alabama
Cherokee	Alabama
Clanton	Alabama
Clay	Alabama
Clayton	Alabama
Cleveland	Alabama
Clio	Alabama
Coker	Alabama
Colony	Alabama
Columbia	Alabama
Cordova	Alabama
Cottonwood	Alabama
Cuba	Alabama
Daphne	Alabama
Dayton	Alabama
Decatur	Alabama
Detroit	Alabama
Dora	Alabama
Dothan	Alabama
Douglas	Alabama
Dozier	Alabama
Dutton	Alabama
Eclectic	Alabama
Eldridge	Alabama
Elmore	Alabama
Enterprise	Alabama
Eva	Alabama
Evergreen	Alabama
Excel	Alabama
Fairfield	Alabama
Florence	Alabama
Foley	Alabama
Franklin	Alabama
Fulton	Alabama
Gadsden	Alabama
Gainesville	Alabama
Gantt	Alabama
Geiger	Alabama
Geneva	Alabama
Geraldine	Alabama
Glenwood	Alabama
Gordo	Alabama
Gordon	Alabama
Goshen	Alabama
Grant	Alabama
Greensboro	Alabama
Greenville	Alabama
Grimes	Alabama
Gurley	Alabama
Hamilton	Alabama
Hartford	Alabama
Hayden	Alabama
Headland	Alabama
Heath	Alabama
Heflin	Alabama
Helena	Alabama
Hillsboro	Alabama
Hodges	Alabama
Hollywood	Alabama
Hoover	Alabama
Huntsville	Alabama
Jackson	Alabama
Jacksonville	Alabama
Jasper	Alabama
Jemison	Alabama
Kansas	Alabama
Kennedy	Alabama
Kimberly	Alabama
Kinsey	Alabama
Lakeview	Alabama
Langston	Alabama
Leeds	Alabama
Leesburg	Alabama
Leighton	Alabama
Lester	Alabama
Lexington	Alabama
Lincoln	Alabama
Linden	Alabama
Livingston	Alabama
Lockhart	Alabama
Louisville	Alabama
Lynn	Alabama
Madison	Alabama
Madrid	Alabama
Malvern	Alabama
Margaret	Alabama
Marion	Alabama
McIntosh	Alabama
McKenzie	Alabama
McMullen	Alabama
Memphis	Alabama
Midfield	Alabama
Midway	Alabama
Mobile	Alabama
Monroeville	Alabama
Montgomery	Alabama
Moody	Alabama
Morris	Alabama
Moulton	Alabama
Nectar	Alabama
Needham	Alabama
Newton	Alabama
Oneonta	Alabama
Oxford	Alabama
Ozark	Alabama
Parrish	Alabama
Pennington	Alabama
Piedmont	Alabama
Pinson	Alabama
Pollard	Alabama
Powell	Alabama
Providence	Alabama
Reform	Alabama
Riverside	Alabama
Riverview	Alabama
Roanoke	Alabama
Rockford	Alabama
Rosa	Alabama
Rutledge	Alabama
Samson	Alabama
Sanford	Alabama
Scottsboro	Alabama
Section	Alabama
Selma	Alabama
Sheffield	Alabama
Shiloh	Alabama
Shorter	Alabama
Silas	Alabama
Skyline	Alabama
Snead	Alabama
Somerville	Alabama
Southside	Alabama
Steele	Alabama
Stevenson	Alabama
Sylvania	Alabama
Talladega	Alabama
Tarrant	Alabama
Taylor	Alabama
Thomasville	Alabama
Trafford	Alabama
Triana	Alabama
Trinity	Alabama
Troy	Alabama
Tuscaloosa	Alabama
Tuskegee	Alabama
Twin	Alabama
Union	Alabama
Uniontown	Alabama
Valley	Alabama
Vance	Alabama
Vernon	Alabama
Vina	Alabama
Vincent	Alabama
Waldo	Alabama
Warrior	Alabama
Waterloo	Alabama
Waverly	Alabama
Weaver	Alabama
Webb	Alabama
Wilton	Alabama
Winfield	Alabama
Woodland	Alabama
Woodstock	Alabama
York	Alabama
Alexandria	Alabama
Axis	Alabama
Bellamy	Alabama
Boykin	Alabama
Bucks	Alabama
Calvert	Alabama
Carlton	Alabama
Catherine	Alabama
Concord	Alabama
Delta	Alabama
Edgewater	Alabama
Egypt	Alabama
Fairford	Alabama
Fayetteville	Alabama
Fitzpatrick	Alabama
Gallant	Alabama
Graham	Alabama
Harvest	Alabama
Hatton	Alabama
Hobson	Alabama
Hollins	Alabama
Holt	Alabama
Leroy	Alabama
Macedonia	Alabama
Malcolm	Alabama
Marbury	Alabama
Mignon	Alabama
Minor	Alabama
Peterman	Alabama
Putnam	Alabama
Ray	Alabama
Rockville	Alabama
Saks	Alabama
Shelby	Alabama
Theodore	Alabama
Anchorage	Alaska
Fairbanks	Alaska
Juneau	Alaska
Badger	Alaska
College	Alaska
Lakes	Alaska
Kenai	Alaska
Kodiak	Alaska
Bethel	Alaska
Palmer	Alaska
Sterling	Alaska
Gateway	Alaska
Homer	Alaska
Barrow	Alaska
Valdez	Alaska
Nome	Alaska
Butte	Alaska
Petersburg	Alaska
Seward	Alaska
Ester	Alaska
Wrangell	Alaska
Cordova	Alaska
Willow	Alaska
Ridgeway	Alaska
Houston	Alaska
Haines	Alaska
Tok	Alaska
Craig	Alaska
Healy	Alaska
Wainwright	Alaska
Galena	Alaska
Fox	Alaska
Buckland	Alaska
Marshall	Alaska
McGrath	Alaska
Eek	Alaska
Anderson	Alaska
Teller	Alaska
Whittier	Alaska
Cantwell	Alaska
Hope	Alaska
Ruby	Alaska
Wales	Alaska
Hollis	Alaska
Circle	Alaska
Whitestone	Alaska
Central	Alaska
Nikolai	Alaska
Pelican	Alaska
Hyder	Alaska
Eagle	Alaska
Beaver	Alaska
Primrose	Alaska
Hughes	Alaska
Platinum	Alaska
Chase	Alaska
Ferry	Alaska
McCarthy	Alaska
Rampart	Alaska
Beluga	Alaska
Sunrise	Alaska
Evansville	Alaska
Wiseman	Alaska
Chicken	Alaska
Loring	Alaska
Flat	Alaska
Alpine	Alaska
Benson	Arizona
Buckeye	Arizona
Carefree	Arizona
Chandler	Arizona
Coolidge	Arizona
Cottonwood	Arizona
Douglas	Arizona
Duncan	Arizona
Gilbert	Arizona
Glendale	Arizona
Goodyear	Arizona
Guadalupe	Arizona
Hayden	Arizona
Jerome	Arizona
Kearny	Arizona
Mammoth	Arizona
Maricopa	Arizona
Mesa	Arizona
Miami	Arizona
Page	Arizona
Patagonia	Arizona
Peoria	Arizona
Pima	Arizona
Scottsdale	Arizona
Sedona	Arizona
Snowflake	Arizona
Somerton	Arizona
Superior	Arizona
Surprise	Arizona
Taylor	Arizona
Tempe	Arizona
Thatcher	Arizona
Tombstone	Arizona
Williams	Arizona
Winslow	Arizona
Alpine	Arizona
Amado	Arizona
Anthem	Arizona
Arlington	Arizona
Aztec	Arizona
Bagdad	Arizona
Bowie	Arizona
Brenda	Arizona
Bryce	Arizona
Cameron	Arizona
Catalina	Arizona
Central	Arizona
Chloride	Arizona
Congress	Arizona
Cutter	Arizona
Drysdale	Arizona
Elgin	Arizona
Franklin	Arizona
Gadsden	Arizona
Greer	Arizona
Kaka	Arizona
Katherine	Arizona
Linden	Arizona
Littlefield	Arizona
McNeal	Arizona
Mayer	Arizona
Morristown	Arizona
Naco	Arizona
Nelson	Arizona
Oracle	Arizona
Parks	Arizona
Pine	Arizona
Poston	Arizona
Roosevelt	Arizona
Rye	Arizona
Salome	Arizona
Sanders	Arizona
Sawmill	Arizona
Scenic	Arizona
Seligman	Arizona
Sells	Arizona
Solomon	Arizona
Stanfield	Arizona
Steamboat	Arizona
Strawberry	Arizona
Summit	Arizona
Vail	Arizona
Valentine	Arizona
Valle	Arizona
Vernon	Arizona
Vicksburg	Arizona
Why	Arizona
Williamson	Arizona
Woodruff	Arizona
Yarnell	Arizona
York	Arizona
Young	Arizona
Yucca	Arizona
Fayetteville	Arkansas
Springdale	Arkansas
Jonesboro	Arkansas
Conway	Arkansas
Rogers	Arkansas
Bentonville	Arkansas
Benton	Arkansas
Texarkana	Arkansas
Sherwood	Arkansas
Jacksonville	Arkansas
Cabot	Arkansas
Bryant	Arkansas
Harrison	Arkansas
Marion	Arkansas
Camden	Arkansas
Magnolia	Arkansas
Arkadelphia	Arkansas
Hope	Arkansas
Monticello	Arkansas
Stuttgart	Arkansas
Clarksville	Arkansas
Greenwood	Arkansas
Newport	Arkansas
Osceola	Arkansas
Lowell	Arkansas
Beebe	Arkansas
Pocahontas	Arkansas
Warren	Arkansas
Farmington	Arkansas
Mena	Arkansas
Alma	Arkansas
Ashdown	Arkansas
Dumas	Arkansas
Greenbrier	Arkansas
Nashville	Arkansas
Sheridan	Arkansas
Marianna	Arkansas
Ward	Arkansas
Haskell	Arkansas
Ozark	Arkansas
Waldron	Arkansas
Paris	Arkansas
Corning	Arkansas
Johnson	Arkansas
Manila	Arkansas
Prescott	Arkansas
DeWitt	Arkansas
Brinkley	Arkansas
Gentry	Arkansas
Atkins	Arkansas
Alexander	Arkansas
Hamburg	Arkansas
England	Arkansas
Elkins	Arkansas
Clinton	Arkansas
Charleston	Arkansas
Earle	Arkansas
Danville	Arkansas
Huntsville	Arkansas
Harrisburg	Arkansas
Eudora	Arkansas
Lincoln	Arkansas
Mayflower	Arkansas
Glenwood	Arkansas
Carlisle	Arkansas
Augusta	Arkansas
Bono	Arkansas
Austin	Arkansas
Rector	Arkansas
Melbourne	Arkansas
Bay	Arkansas
Decatur	Arkansas
Stamps	Arkansas
Clarendon	Arkansas
Mulberry	Arkansas
Salem	Arkansas
Lamar	Arkansas
Hazen	Arkansas
Hughes	Arkansas
Dover	Arkansas
Waldo	Arkansas
Marshall	Arkansas
Hampton	Arkansas
Diaz	Arkansas
Alameda	California
Albany	California
Anaheim	California
Anderson	California
Antioch	California
Arcadia	California
Atherton	California
Atwater	California
Avalon	California
Banning	California
Barstow	California
Beaumont	California
Bell	California
Belmont	California
Berkeley	California
Biggs	California
Bishop	California
Blythe	California
Bradbury	California
Brawley	California
Brea	California
Brentwood	California
Brisbane	California
Burbank	California
Burlingame	California
Calabasas	California
Camarillo	California
Campbell	California
Carlsbad	California
Carson	California
Cerritos	California
Chico	California
Chino	California
Claremont	California
Clayton	California
Cloverdale	California
Clovis	California
Colton	California
Commerce	California
Compton	California
Concord	California
Corcoran	California
Corning	California
Corona	California
Coronado	California
Covina	California
Cupertino	California
Cypress	California
Danville	California
Davis	California
Delano	California
Dixon	California
Dorris	California
Downey	California
Duarte	California
Dublin	California
Escondido	California
Etna	California
Exeter	California
Fairfax	California
Ferndale	California
Fillmore	California
Folsom	California
Fontana	California
Fortuna	California
Fowler	California
Fremont	California
Fullerton	California
Gardena	California
Gilroy	California
Glendale	California
Gonzales	California
Greenfield	California
Guadalupe	California
Hawthorne	California
Hayward	California
Hercules	California
Highland	California
Hillsborough	California
Huron	California
Imperial	California
Industry	California
Inglewood	California
Irvine	California
Lafayette	California
Lakewood	California
Lancaster	California
Lincoln	California
Lindsay	California
Livermore	California
Livingston	California
Lodi	California
Loomis	California
Malibu	California
Maricopa	California
Marina	California
McFarland	California
Monrovia	California
Montague	California
Montclair	California
Montebello	California
Monterey	California
Needles	California
Newark	California
Newman	California
Norwalk	California
Novato	California
Oakley	California
Oceanside	California
Ojai	California
Ontario	California
Orange	California
Oxnard	California
Pacifica	California
Palmdale	California
Paradise	California
Paramount	California
Pasadena	California
Patterson	California
Petaluma	California
Piedmont	California
Pittsburg	California
Pleasanton	California
Plymouth	California
Pomona	California
Richmond	California
Riverbank	California
Roseville	California
Ross	California
Sanger	California
Santee	California
Saratoga	California
Sausalito	California
Seaside	California
Selma	California
Soledad	California
Sonoma	California
Stanton	California
Sunnyvale	California
Taft	California
Temecula	California
Torrance	California
Tracy	California
Trinidad	California
Truckee	California
Tustin	California
Upland	California
Vacaville	California
Vallejo	California
Vernon	California
Victorville	California
Vista	California
Walnut	California
Waterford	California
Watsonville	California
Weed	California
Westminster	California
Whittier	California
Williams	California
Windsor	California
Winters	California
Woodside	California
Aguilar	Colorado
Akron	Colorado
Alma	Colorado
Aspen	Colorado
Ault	Colorado
Aurora	Colorado
Avon	Colorado
Basalt	Colorado
Bennett	Colorado
Bethune	Colorado
Blanca	Colorado
Bonanza	Colorado
Boone	Colorado
Boulder	Colorado
Branson	Colorado
Breckenridge	Colorado
Brighton	Colorado
Brookside	Colorado
Broomfield	Colorado
Brush	Colorado
Burlington	Colorado
Campo	Colorado
Carbondale	Colorado
Centennial	Colorado
Center	Colorado
Cortez	Colorado
Craig	Colorado
Crawford	Colorado
Crook	Colorado
Crowley	Colorado
Delta	Colorado
Denver	Colorado
Dillon	Colorado
Dinosaur	Colorado
Dolores	Colorado
Durango	Colorado
Eads	Colorado
Eagle	Colorado
Eaton	Colorado
Edgewater	Colorado
Elizabeth	Colorado
Empire	Colorado
Englewood	Colorado
Erie	Colorado
Evans	Colorado
Firestone	Colorado
Fleming	Colorado
Florence	Colorado
Fountain	Colorado
Fowler	Colorado
Fraser	Colorado
Frederick	Colorado
Frisco	Colorado
Genoa	Colorado
Georgetown	Colorado
Glendale	Colorado
Golden	Colorado
Granada	Colorado
Greeley	Colorado
Grover	Colorado
Gunnison	Colorado
Gypsum	Colorado
Hartman	Colorado
Hayden	Colorado
Holly	Colorado
Holyoke	Colorado
Hooper	Colorado
Hotchkiss	Colorado
Hudson	Colorado
Hugo	Colorado
Ignacio	Colorado
Jamestown	Colorado
Johnstown	Colorado
Kim	Colorado
Kiowa	Colorado
Lafayette	Colorado
Lakeside	Colorado
Lakewood	Colorado
Lamar	Colorado
LaSalle	Colorado
Littleton	Colorado
Louisville	Colorado
Loveland	Colorado
Lyons	Colorado
Marble	Colorado
Mead	Colorado
Merino	Colorado
Milliken	Colorado
Moffat	Colorado
Montezuma	Colorado
Montrose	Colorado
Monument	Colorado
Morrison	Colorado
Norwood	Colorado
Nunn	Colorado
Otis	Colorado
Paoli	Colorado
Parachute	Colorado
Parker	Colorado
Pierce	Colorado
Pitkin	Colorado
Pritchett	Colorado
Pueblo	Colorado
Rico	Colorado
Ridgway	Colorado
Rifle	Colorado
Romeo	Colorado
Rye	Colorado
Sanford	Colorado
Sedgwick	Colorado
Severance	Colorado
Sheridan	Colorado
Silt	Colorado
Springfield	Colorado
Sterling	Colorado
Stratton	Colorado
Superior	Colorado
Telluride	Colorado
Thornton	Colorado
Trinidad	Colorado
Vail	Colorado
Victor	Colorado
Walden	Colorado
Walsh	Colorado
Ward	Colorado
Wellington	Colorado
Westminster	Colorado
Wiggins	Colorado
Wiley	Colorado
Williamsburg	Colorado
Windsor	Colorado
Wray	Colorado
Yuma	Colorado
Bridgeport	Ansonia
Bristol	Ansonia
Danbury	Ansonia
Derby	Ansonia
Groton	Ansonia
Hartford	Ansonia
Meriden	Ansonia
Middletown	Ansonia
Milford	Ansonia
Norwalk	Ansonia
Norwich	Ansonia
Shelton	Ansonia
Stamford	Ansonia
Torrington	Ansonia
Waterbury	Ansonia
Wilmington	Delaware
Dover	Delaware
Newark	Delaware
Middletown	Delaware
Smyrna	Delaware
Milford	Delaware
Georgetown	Delaware
Laurel	Delaware
Harrington	Delaware
Camden	Delaware
Clayton	Delaware
Milton	Delaware
Townsend	Delaware
Delmar	Delaware
Wyoming	Delaware
Felton	Delaware
Blades	Delaware
Newport	Delaware
Greenwood	Delaware
Frankford	Delaware
Frederica	Delaware
Millville	Delaware
Arden	Delaware
Houston	Delaware
Odessa	Delaware
Bowers	Delaware
Kenton	Delaware
Magnolia	Delaware
Woodside	Delaware
Bethel	Delaware
Viola	Delaware
Farmington	Delaware
Alford	Florida
Apalachicola	Florida
Apopka	Florida
Arcadia	Florida
Archer	Florida
Atlantis	Florida
Baldwin	Florida
Bartow	Florida
Bell	Florida
Belleview	Florida
Bradenton	Florida
Branford	Florida
Bristol	Florida
Bronson	Florida
Brooksville	Florida
Callahan	Florida
Callaway	Florida
Century	Florida
Chattahoochee	Florida
Clearwater	Florida
Clermont	Florida
Cocoa	Florida
Davenport	Florida
Davie	Florida
DeLand	Florida
Destin	Florida
Dundee	Florida
Dunedin	Florida
Edgewater	Florida
Edgewood	Florida
Freeport	Florida
Gainesville	Florida
Golf	Florida
Greensboro	Florida
Greenville	Florida
Greenwood	Florida
Gretna	Florida
Gulfport	Florida
Hampton	Florida
Hastings	Florida
Havana	Florida
Haverhill	Florida
Hawthorne	Florida
Hialeah	Florida
Hilliard	Florida
Hollywood	Florida
Homestead	Florida
Inglis	Florida
Inverness	Florida
Jacksonville	Florida
Jasper	Florida
Jay	Florida
Jennings	Florida
Jupiter	Florida
Kissimmee	Florida
LaBelle	Florida
Lakeland	Florida
Largo	Florida
Layton	Florida
Lee	Florida
Leesburg	Florida
Longwood	Florida
Madison	Florida
Malone	Florida
Marathon	Florida
Marianna	Florida
Mayo	Florida
McIntosh	Florida
Medley	Florida
Melbourne	Florida
Miami	Florida
Midway	Florida
Milton	Florida
Miramar	Florida
Monticello	Florida
Mulberry	Florida
Naples	Florida
Newberry	Florida
Oakland	Florida
Ocala	Florida
Okeechobee	Florida
Orchid	Florida
Orlando	Florida
Oviedo	Florida
Palmetto	Florida
Parker	Florida
Parkland	Florida
Paxton	Florida
Pensacola	Florida
Perry	Florida
Pierson	Florida
Plantation	Florida
Quincy	Florida
Sanford	Florida
Sanibel	Florida
Sarasota	Florida
Sebastian	Florida
Sebring	Florida
Seminole	Florida
Springfield	Florida
Stuart	Florida
Sunrise	Florida
Surfside	Florida
Sweetwater	Florida
Tallahassee	Florida
Tampa	Florida
Titusville	Florida
Trenton	Florida
Venice	Florida
Vernon	Florida
Waldo	Florida
Wausau	Florida
Webster	Florida
Wellington	Florida
Weston	Florida
Wildwood	Florida
Atlanta	Georgia
Augusta	Georgia
Columbus	Georgia
Savannah	Georgia
Athens	Georgia
Roswell	Georgia
Macon	Georgia
Albany	Georgia
Alpharetta	Georgia
Marietta	Georgia
Valdosta	Georgia
Smyrna	Georgia
Rome	Georgia
Milton	Georgia
Gainesville	Georgia
Dalton	Georgia
Kennesaw	Georgia
LaGrange	Georgia
Statesboro	Georgia
Lawrenceville	Georgia
Duluth	Georgia
Stockbridge	Georgia
Woodstock	Georgia
Carrollton	Georgia
Canton	Georgia
Griffin	Georgia
McDonough	Georgia
Decatur	Georgia
Thomasville	Georgia
Americus	Georgia
Dublin	Georgia
Fayetteville	Georgia
Calhoun	Georgia
Brunswick	Georgia
Norcross	Georgia
Riverdale	Georgia
Conyers	Georgia
Perry	Georgia
Winder	Georgia
Monroe	Georgia
Covington	Georgia
Buford	Georgia
Bainbridge	Georgia
Dallas	Georgia
Douglas	Georgia
Vidalia	Georgia
Cairo	Georgia
Jefferson	Georgia
Rincon	Georgia
Fitzgerald	Georgia
Centerville	Georgia
Hampton	Georgia
LaFayette	Georgia
Auburn	Georgia
Honolulu	Hawaii
Hilo	Hawaii
Kula	Hawaii
Kilauea	Hawaii
Volcano	Hawaii
Hana	Hawaii
Boise	Idaho
Meridian	Idaho
Pocatello	Idaho
Caldwell	Idaho
Lewiston	Idaho
Moscow	Idaho
Eagle	Idaho
Kuna	Idaho
Hayden	Idaho
Blackfoot	Idaho
Jerome	Idaho
Burley	Idaho
Hailey	Idaho
Payette	Idaho
Emmett	Idaho
Star	Idaho
Rupert	Idaho
Middleton	Idaho
Weiser	Idaho
Preston	Idaho
Shelley	Idaho
Rigby	Idaho
Gooding	Idaho
Kimberly	Idaho
Salmon	Idaho
McCall	Idaho
Wendell	Idaho
Ketchum	Idaho
Montpelier	Idaho
Bellevue	Idaho
Kellogg	Idaho
Aberdeen	Idaho
Parma	Idaho
Victor	Idaho
Iona	Idaho
Wilder	Idaho
Shoshone	Idaho
Paul	Idaho
Hansen	Idaho
Ashton	Idaho
Plummer	Idaho
Arco	Idaho
Cascade	Idaho
Grace	Idaho
Cottonwood	Idaho
Hagerman	Idaho
Troy	Idaho
Greenleaf	Idaho
Council	Idaho
Wallace	Idaho
Oakley	Idaho
Hazelton	Idaho
Teton	Idaho
Athol	Idaho
Hauser	Idaho
Dubois	Idaho
Franklin	Idaho
Downey	Idaho
Carey	Idaho
Roberts	Idaho
Dover	Idaho
Mackay	Idaho
Melba	Idaho
Paris	Idaho
Pierce	Idaho
Richfield	Idaho
Firth	Idaho
Georgetown	Idaho
Dayton	Idaho
Weston	Idaho
Riggins	Idaho
Fairfield	Idaho
Eden	Idaho
Basalt	Idaho
Bancroft	Idaho
Winchester	Idaho
Dietrich	Idaho
Cambridge	Idaho
Bliss	Idaho
Parker	Idaho
Kendrick	Idaho
Rockland	Idaho
Albion	Idaho
Clifton	Idaho
Worley	Idaho
Irwin	Idaho
Bloomington	Idaho
Harrison	Idaho
Peck	Idaho
Malta	Idaho
Moore	Idaho
Crouch	Idaho
Ferdinand	Idaho
Donnelly	Idaho
Hope	Idaho
Stanley	Idaho
Oxford	Idaho
Hamer	Idaho
Spencer	Idaho
Drummond	Idaho
Clayton	Idaho
Chicago	Illinois
Aurora	Illinois
Rockford	Illinois
Joliet	Illinois
Naperville	Illinois
Springfield	Illinois
Peoria	Illinois
Elgin	Illinois
Waukegan	Illinois
Cicero	Illinois
Champaign	Illinois
Bloomington	Illinois
Decatur	Illinois
Evanston	Illinois
Schaumburg	Illinois
Palatine	Illinois
Skokie	Illinois
Wheaton	Illinois
Normal	Illinois
Glenview	Illinois
Belleville	Illinois
Elmhurst	Illinois
DeKalb	Illinois
Moline	Illinois
Lombard	Illinois
Urbana	Illinois
Bartlett	Illinois
Quincy	Illinois
Plainfield	Illinois
Wheeling	Illinois
Addison	Illinois
Northbrook	Illinois
Danville	Illinois
Galesburg	Illinois
Oswego	Illinois
Algonquin	Illinois
Niles	Illinois
Burbank	Illinois
Lansing	Illinois
Alton	Illinois
Kankakee	Illinois
McHenry	Illinois
Batavia	Illinois
Carbondale	Illinois
Freeport	Illinois
Harvey	Illinois
Lockport	Illinois
Woodstock	Illinois
Zion	Illinois
Huntley	Illinois
Roselle	Illinois
Darien	Illinois
Bloomingdale	Illinois
Charleston	Illinois
Geneva	Illinois
Jacksonville	Illinois
Macomb	Illinois
Ottawa	Illinois
Montgomery	Illinois
Cary	Illinois
Deerfield	Illinois
Godfrey	Illinois
Frankfort	Illinois
Sycamore	Illinois
Marion	Illinois
Indianapolis	Indiana
Evansville	Indiana
Carmel	Indiana
Bloomington	Indiana
Fishers	Indiana
Hammond	Indiana
Gary	Indiana
Muncie	Indiana
Lafayette	Indiana
Kokomo	Indiana
Anderson	Indiana
Greenwood	Indiana
Lawrence	Indiana
Columbus	Indiana
Portage	Indiana
Richmond	Indiana
Westfield	Indiana
Goshen	Indiana
Marion	Indiana
Plainfield	Indiana
Hobart	Indiana
Franklin	Indiana
Highland	Indiana
Munster	Indiana
Clarksville	Indiana
Greenfield	Indiana
Seymour	Indiana
Vincennes	Indiana
Huntington	Indiana
Griffith	Indiana
Dyer	Indiana
Frankfort	Indiana
Lebanon	Indiana
Jasper	Indiana
Warsaw	Indiana
Bedford	Indiana
Avon	Indiana
Auburn	Indiana
Madison	Indiana
Speedway	Indiana
Martinsville	Indiana
Washington	Indiana
Peru	Indiana
Wabash	Indiana
Plymouth	Indiana
Adair	Iowa
Afton	Iowa
Agency	Iowa
Akron	Iowa
Albion	Iowa
Alden	Iowa
Alexander	Iowa
Alta	Iowa
Alton	Iowa
Altoona	Iowa
Ames	Iowa
Andover	Iowa
Andrew	Iowa
Anita	Iowa
Arcadia	Iowa
Archer	Iowa
Arlington	Iowa
Armstrong	Iowa
Arthur	Iowa
Asbury	Iowa
Ashton	Iowa
Atkins	Iowa
Auburn	Iowa
Aurora	Iowa
Badger	Iowa
Bagley	Iowa
Baldwin	Iowa
Bancroft	Iowa
Barnum	Iowa
Bassett	Iowa
Batavia	Iowa
Baxter	Iowa
Bayard	Iowa
Beacon	Iowa
Beaver	Iowa
Bellevue	Iowa
Bennett	Iowa
Benton	Iowa
Berkley	Iowa
Bernard	Iowa
Bertram	Iowa
Bettendorf	Iowa
Birmingham	Iowa
Blanchard	Iowa
Bode	Iowa
Bonaparte	Iowa
Bouton	Iowa
Boyden	Iowa
Brandon	Iowa
Breda	Iowa
Bridgewater	Iowa
Brighton	Iowa
Bristow	Iowa
Britt	Iowa
Bronson	Iowa
Brooklyn	Iowa
Buckeye	Iowa
Buffalo	Iowa
Burt	Iowa
Calumet	Iowa
Cambridge	Iowa
Carbon	Iowa
Carlisle	Iowa
Carpenter	Iowa
Carson	Iowa
Cascade	Iowa
Casey	Iowa
Centralia	Iowa
Charlotte	Iowa
Chatsworth	Iowa
Chelsea	Iowa
Chester	Iowa
Chillicothe	Iowa
Cincinnati	Iowa
Clare	Iowa
Clarence	Iowa
Clarksville	Iowa
Clayton	Iowa
Clermont	Iowa
Clio	Iowa
Clive	Iowa
Coin	Iowa
Collins	Iowa
Conrad	Iowa
Conway	Iowa
Cotter	Iowa
Coulter	Iowa
Craig	Iowa
Crescent	Iowa
Cromwell	Iowa
Cumberland	Iowa
Cushing	Iowa
Cylinder	Iowa
Dana	Iowa
Danbury	Iowa
Danville	Iowa
Dawson	Iowa
Dayton	Iowa
Dedham	Iowa
Defiance	Iowa
Delaware	Iowa
Delhi	Iowa
Delmar	Iowa
Delta	Iowa
Denver	Iowa
Derby	Iowa
Dexter	Iowa
Diagonal	Iowa
Dickens	Iowa
Dike	Iowa
Dixon	Iowa
Donahue	Iowa
Dougherty	Iowa
Dumont	Iowa
Dundee	Iowa
Dunlap	Iowa
Durango	Iowa
Durant	Iowa
Early	Iowa
Edgewood	Iowa
Eldon	Iowa
Eldridge	Iowa
Elgin	Iowa
Elliott	Iowa
Ellsworth	Iowa
Ely	Iowa
Emerson	Iowa
Essex	Iowa
Fairfax	Iowa
Farley	Iowa
Farmington	Iowa
Fenton	Iowa
Ferguson	Iowa
Fertile	Iowa
Floyd	Iowa
Fonda	Iowa
Franklin	Iowa
Fraser	Iowa
Fredericksburg	Iowa
Fremont	Iowa
Garber	Iowa
Garrison	Iowa
Geneva	Iowa
George	Iowa
Gibson	Iowa
Gilbert	Iowa
Gilman	Iowa
Graf	Iowa
Grafton	Iowa
Grandview	Iowa
Granger	Iowa
Grant	Iowa
Granville	Iowa
Gravity	Iowa
Gray	Iowa
Greeley	Iowa
Greene	Iowa
Greenville	Iowa
Grimes	Iowa
Griswold	Iowa
Guttenberg	Iowa
Hamburg	Iowa
Hamilton	Iowa
Hancock	Iowa
Harcourt	Iowa
Hardy	Iowa
Harper	Iowa
Harris	Iowa
Hartford	Iowa
Hartley	Iowa
Harvey	Iowa
Hastings	Iowa
Haverhill	Iowa
Hawkeye	Iowa
Hedrick	Iowa
Henderson	Iowa
Hepburn	Iowa
Hills	Iowa
Hillsboro	Iowa
Hinton	Iowa
Holland	Iowa
Holstein	Iowa
Houghton	Iowa
Hubbard	Iowa
Hudson	Iowa
Hull	Iowa
Humboldt	Iowa
Huxley	Iowa
Imogene	Iowa
Irwin	Iowa
Jamaica	Iowa
Johnston	Iowa
Kelley	Iowa
Kellogg	Iowa
Keystone	Iowa
Kingsley	Iowa
Kirkman	Iowa
Lakeside	Iowa
Lakota	Iowa
Lamont	Iowa
Lansing	Iowa
Larrabee	Iowa
Latimer	Iowa
Laurel	Iowa
Laurens	Iowa
Lawton	Iowa
Ledyard	Iowa
Lehigh	Iowa
Leighton	Iowa
Leland	Iowa
Lenox	Iowa
Lester	Iowa
Lewis	Iowa
Lincoln	Iowa
Linden	Iowa
Lisbon	Iowa
Livermore	Iowa
Lucas	Iowa
Luther	Iowa
Macedonia	Iowa
Madrid	Iowa
Magnolia	Iowa
Malcom	Iowa
Mallard	Iowa
Malvern	Iowa
Manly	Iowa
Manning	Iowa
Manson	Iowa
Marathon	Iowa
Marcus	Iowa
Marion	Iowa
Marquette	Iowa
Martinsburg	Iowa
Marysville	Iowa
Matlock	Iowa
Maurice	Iowa
Maxwell	Iowa
Maynard	Iowa
McClelland	Iowa
McGregor	Iowa
McIntire	Iowa
Mechanicsville	Iowa
Melbourne	Iowa
Melrose	Iowa
Melvin	Iowa
Menlo	Iowa
Meriden	Iowa
Merrill	Iowa
Middletown	Iowa
Miles	Iowa
Milford	Iowa
Millville	Iowa
Milo	Iowa
Milton	Iowa
Minden	Iowa
Mitchell	Iowa
Monmouth	Iowa
Monroe	Iowa
Monticello	Iowa
Montrose	Iowa
Moorhead	Iowa
Morley	Iowa
Morrison	Iowa
Moulton	Iowa
Murray	Iowa
Mystic	Iowa
Nashua	Iowa
Newell	Iowa
Nichols	Iowa
Norwalk	Iowa
Norway	Iowa
Oakland	Iowa
Ogden	Iowa
Olds	Iowa
Olin	Iowa
Ollie	Iowa
Orchard	Iowa
Orient	Iowa
Orleans	Iowa
Oxford	Iowa
Packwood	Iowa
Palmer	Iowa
Palo	Iowa
Panama	Iowa
Parkersburg	Iowa
Parnell	Iowa
Paton	Iowa
Patterson	Iowa
Pella	Iowa
Perry	Iowa
Persia	Iowa
Peterson	Iowa
Pierson	Iowa
Pioneer	Iowa
Plainfield	Iowa
Plano	Iowa
Pleasanton	Iowa
Pleasantville	Iowa
Plymouth	Iowa
Pomeroy	Iowa
Portsmouth	Iowa
Prescott	Iowa
Preston	Iowa
Princeton	Iowa
Pulaski	Iowa
Radcliffe	Iowa
Rake	Iowa
Ralston	Iowa
Randall	Iowa
Randolph	Iowa
Rathbun	Iowa
Raymond	Iowa
Redding	Iowa
Redfield	Iowa
Rembrandt	Iowa
Renwick	Iowa
Rhodes	Iowa
Richland	Iowa
Ricketts	Iowa
Ridgeway	Iowa
Riverdale	Iowa
Riverside	Iowa
Robins	Iowa
Rockford	Iowa
Rockwell	Iowa
Rodman	Iowa
Rodney	Iowa
Roland	Iowa
Rome	Iowa
Rowan	Iowa
Rowley	Iowa
Royal	Iowa
Rudd	Iowa
Russell	Iowa
Ryan	Iowa
Salem	Iowa
Sanborn	Iowa
Schaller	Iowa
Scranton	Iowa
Seymour	Iowa
Sheffield	Iowa
Shelby	Iowa
Sheldon	Iowa
Shenandoah	Iowa
Sherrill	Iowa
Slater	Iowa
Sloan	Iowa
Soldier	Iowa
Somers	Iowa
Stanley	Iowa
Stanton	Iowa
Stockton	Iowa
Stout	Iowa
Stratford	Iowa
Struble	Iowa
Stuart	Iowa
Sully	Iowa
Sumner	Iowa
Superior	Iowa
Sutherland	Iowa
Swan	Iowa
Swisher	Iowa
Tabor	Iowa
Tama	Iowa
Templeton	Iowa
Tennant	Iowa
Thayer	Iowa
Thompson	Iowa
Thor	Iowa
Thornburg	Iowa
Thornton	Iowa
Thurman	Iowa
Toronto	Iowa
Tripoli	Iowa
Turin	Iowa
Underwood	Iowa
Union	Iowa
Urbana	Iowa
Ute	Iowa
Vail	Iowa
Ventura	Iowa
Victor	Iowa
Vincent	Iowa
Volga	Iowa
Walcott	Iowa
Walker	Iowa
Walnut	Iowa
Waterville	Iowa
Wayland	Iowa
Webb	Iowa
Webster	Iowa
Weldon	Iowa
Wesley	Iowa
Westfield	Iowa
Westgate	Iowa
Westside	Iowa
Westwood	Iowa
Whiting	Iowa
Whitten	Iowa
Willey	Iowa
Williams	Iowa
Williamsburg	Iowa
Williamson	Iowa
Wilton	Iowa
Winfield	Iowa
Winthrop	Iowa
Woodward	Iowa
Worthington	Iowa
Wyoming	Iowa
Yale	Iowa
Yorktown	Iowa
Wichita	Kansas
Topeka	Kansas
Lawrence	Kansas
Shawnee	Kansas
Manhattan	Kansas
Hutchinson	Kansas
Leavenworth	Kansas
Emporia	Kansas
Derby	Kansas
Liberal	Kansas
Hays	Kansas
Pittsburg	Kansas
Gardner	Kansas
Newton	Kansas
McPherson	Kansas
Ottawa	Kansas
Winfield	Kansas
Andover	Kansas
Lansing	Kansas
Merriam	Kansas
Atchison	Kansas
Parsons	Kansas
Mission	Kansas
Independence	Kansas
Augusta	Kansas
Chanute	Kansas
Wellington	Kansas
Pratt	Kansas
Abilene	Kansas
Ulysses	Kansas
Eudora	Kansas
Paola	Kansas
Colby	Kansas
Goddard	Kansas
Russell	Kansas
Albany	Kentucky
Alexandria	Kentucky
Allen	Kentucky
Anchorage	Kentucky
Arlington	Kentucky
Ashland	Kentucky
Auburn	Kentucky
Augusta	Kentucky
Bancroft	Kentucky
Barlow	Kentucky
Bedford	Kentucky
Bellevue	Kentucky
Benham	Kentucky
Benton	Kentucky
Berea	Kentucky
Berry	Kentucky
Blaine	Kentucky
Bloomfield	Kentucky
Brandenburg	Kentucky
Bremen	Kentucky
Brodhead	Kentucky
Bromley	Kentucky
Brooksville	Kentucky
Brownsville	Kentucky
Butler	Kentucky
Cadiz	Kentucky
Calhoun	Kentucky
California	Kentucky
Cambridge	Kentucky
Carlisle	Kentucky
Carrollton	Kentucky
Clarkson	Kentucky
Clay	Kentucky
Clinton	Kentucky
Columbia	Kentucky
Columbus	Kentucky
Concord	Kentucky
Corbin	Kentucky
Covington	Kentucky
Cumberland	Kentucky
Danville	Kentucky
Dayton	Kentucky
Dixon	Kentucky
Dover	Kentucky
Edgewood	Kentucky
Edmonton	Kentucky
Elizabethtown	Kentucky
Eminence	Kentucky
Erlanger	Kentucky
Ewing	Kentucky
Fairfield	Kentucky
Falmouth	Kentucky
Ferguson	Kentucky
Florence	Kentucky
Frankfort	Kentucky
Franklin	Kentucky
Fulton	Kentucky
Georgetown	Kentucky
Germantown	Kentucky
Glasgow	Kentucky
Glenview	Kentucky
Goshen	Kentucky
Gratz	Kentucky
Grayson	Kentucky
Greenup	Kentucky
Greenville	Kentucky
Guthrie	Kentucky
Hanson	Kentucky
Hardin	Kentucky
Harlan	Kentucky
Hartford	Kentucky
Hazard	Kentucky
Hazel	Kentucky
Henderson	Kentucky
Hickman	Kentucky
Hindman	Kentucky
Independence	Kentucky
Inez	Kentucky
Irvine	Kentucky
Island	Kentucky
Jackson	Kentucky
Jamestown	Kentucky
Jenkins	Kentucky
Keene	Kentucky
Kingsley	Kentucky
LaFayette	Kentucky
Lancaster	Kentucky
Lebanon	Kentucky
Lewisburg	Kentucky
Lexington	Kentucky
Liberty	Kentucky
Livermore	Kentucky
Livingston	Kentucky
London	Kentucky
Louisa	Kentucky
Louisville	Kentucky
Ludlow	Kentucky
Lynch	Kentucky
Lyndon	Kentucky
Madisonville	Kentucky
Manchester	Kentucky
Marion	Kentucky
Martin	Kentucky
Mayfield	Kentucky
McHenry	Kentucky
McKee	Kentucky
Melbourne	Kentucky
Mentor	Kentucky
Middletown	Kentucky
Midway	Kentucky
Milton	Kentucky
Monterey	Kentucky
Monticello	Kentucky
Morehead	Kentucky
Morgantown	Kentucky
Murray	Kentucky
Newport	Kentucky
Northfield	Kentucky
Norwood	Kentucky
Oakland	Kentucky
Paducah	Kentucky
Paris	Kentucky
Plantation	Kentucky
Princeton	Kentucky
Prospect	Kentucky
Providence	Kentucky
Richmond	Kentucky
Robards	Kentucky
Rochester	Kentucky
Russell	Kentucky
Sacramento	Kentucky
Salem	Kentucky
Sanders	Kentucky
Slaughters	Kentucky
Smithfield	Kentucky
Somerset	Kentucky
Sonora	Kentucky
Southgate	Kentucky
Sparta	Kentucky
Springfield	Kentucky
Stanford	Kentucky
Stanton	Kentucky
Sycamore	Kentucky
Trenton	Kentucky
Union	Kentucky
Uniontown	Kentucky
Upton	Kentucky
Versailles	Kentucky
Walton	Kentucky
Warfield	Kentucky
Warsaw	Kentucky
Waverly	Kentucky
Wayland	Kentucky
Wellington	Kentucky
Westwood	Kentucky
Wilder	Kentucky
Wildwood	Kentucky
Williamsburg	Kentucky
Winchester	Kentucky
Woodbury	Kentucky
Worthington	Kentucky
Abbeville	Louisiana
Addis	Louisiana
Albany	Louisiana
Alexandria	Louisiana
Amelia	Louisiana
Angie	Louisiana
Arabi	Louisiana
Arcadia	Louisiana
Ashland	Louisiana
Athens	Louisiana
Atlanta	Louisiana
Baker	Louisiana
Baldwin	Louisiana
Ball	Louisiana
Baskin	Louisiana
Belmont	Louisiana
Benton	Louisiana
Bernice	Louisiana
Berwick	Louisiana
Blanchard	Louisiana
Bonita	Louisiana
Boyce	Louisiana
Branch	Louisiana
Broussard	Louisiana
Brownfields	Louisiana
Brownsville	Louisiana
Cade	Louisiana
Calhoun	Louisiana
Calvin	Louisiana
Cameron	Louisiana
Castor	Louisiana
Cecilia	Louisiana
Central	Louisiana
Chalmette	Louisiana
Chatham	Louisiana
Choctaw	Louisiana
Claiborne	Louisiana
Clarence	Louisiana
Clarks	Louisiana
Clayton	Louisiana
Clinton	Louisiana
Columbia	Louisiana
Convent	Louisiana
Converse	Louisiana
Covington	Louisiana
Crescent	Louisiana
Crowley	Louisiana
Cullen	Louisiana
Delhi	Louisiana
Delta	Louisiana
Deville	Louisiana
Dodson	Louisiana
Eastwood	Louisiana
Egan	Louisiana
Elizabeth	Louisiana
Elton	Louisiana
Empire	Louisiana
Eros	Louisiana
Estelle	Louisiana
Eunice	Louisiana
Evergreen	Louisiana
Fenton	Louisiana
Fisher	Louisiana
Folsom	Louisiana
Forest	Louisiana
Franklin	Louisiana
Galliano	Louisiana
Georgetown	Louisiana
Gilbert	Louisiana
Gilliam	Louisiana
Gillis	Louisiana
Gonzales	Louisiana
Gramercy	Louisiana
Gray	Louisiana
Grayson	Louisiana
Greenwood	Louisiana
Gretna	Louisiana
Hammond	Louisiana
Harvey	Louisiana
Hayes	Louisiana
Heflin	Louisiana
Henderson	Louisiana
Hester	Louisiana
Hodge	Louisiana
Homer	Louisiana
Ida	Louisiana
Independence	Louisiana
Iota	Louisiana
Iowa	Louisiana
Jackson	Louisiana
Jamestown	Louisiana
Jefferson	Louisiana
Jennings	Louisiana
Jonesboro	Louisiana
Joyce	Louisiana
Kaplan	Louisiana
Kenner	Louisiana
Killian	Louisiana
Kinder	Louisiana
Kraft	Louisiana
Lafayette	Louisiana
Lakeshore	Louisiana
Lakeview	Louisiana
Lillie	Louisiana
Lisbon	Louisiana
Livingston	Louisiana
Livonia	Louisiana
Lockport	Louisiana
Longstreet	Louisiana
Lucky	Louisiana
Lydia	Louisiana
Madisonville	Louisiana
Mansfield	Louisiana
Many	Louisiana
Marion	Louisiana
Marrero	Louisiana
Martin	Louisiana
Mathews	Louisiana
Maurice	Louisiana
Melville	Louisiana
Metairie	Louisiana
Midway	Louisiana
Milton	Louisiana
Minden	Louisiana
Monroe	Louisiana
Monterey	Louisiana
Montgomery	Louisiana
Monticello	Louisiana
Montpelier	Louisiana
Moonshine	Louisiana
Morse	Louisiana
Mound	Louisiana
Natchez	Louisiana
Noble	Louisiana
Norwood	Louisiana
Oberlin	Louisiana
Palmetto	Louisiana
Paradis	Louisiana
Parks	Louisiana
Patterson	Louisiana
Paulina	Louisiana
Pioneer	Louisiana
Pitkin	Louisiana
Pollock	Louisiana
Prospect	Louisiana
Reeves	Louisiana
Reserve	Louisiana
Richmond	Louisiana
Roanoke	Louisiana
Ruston	Louisiana
Saline	Louisiana
Scott	Louisiana
Shenandoah	Louisiana
Shreveport	Louisiana
Sibley	Louisiana
Sikes	Louisiana
Simpson	Louisiana
Singer	Louisiana
Slaughter	Louisiana
Spokane	Louisiana
Springfield	Louisiana
Springhill	Louisiana
Stanley	Louisiana
Starks	Louisiana
Start	Louisiana
Stonewall	Louisiana
Sun	Louisiana
Sunset	Louisiana
Supreme	Louisiana
Swartz	Louisiana
Taft	Louisiana
Tallulah	Louisiana
Triumph	Louisiana
Union	Louisiana
Venice	Louisiana
Vidalia	Louisiana
Vienna	Louisiana
Vinton	Louisiana
Violet	Louisiana
Vivian	Louisiana
Walker	Louisiana
Wallace	Louisiana
Washington	Louisiana
Waterproof	Louisiana
Welcome	Louisiana
Welsh	Louisiana
Westlake	Louisiana
Westminster	Louisiana
Wilson	Louisiana
Wisner	Louisiana
Zachary	Louisiana
Auburn	Maine
Augusta	Maine
Bangor	Maine
Bath	Maine
Belfast	Maine
Brewer	Maine
Calais	Maine
Caribou	Maine
Ellsworth	Maine
Gardiner	Maine
Lewiston	Maine
Portland	Maine
Rockland	Maine
Sanford	Maine
Waterville	Maine
Westbrook	Maine
Aberdeen	Maryland
Annapolis	Maryland
Baltimore	Maryland
Bowie	Maryland
Brunswick	Maryland
Cambridge	Maryland
Cumberland	Maryland
Frederick	Maryland
Gaithersburg	Maryland
Greenbelt	Maryland
Hagerstown	Maryland
Laurel	Maryland
Rockville	Maryland
Salisbury	Maryland
Westminster	Maryland
Attleboro	Massachusetts
Beverly	Massachusetts
Boston	Massachusetts
Bridgewater	Massachusetts
Cambridge	Massachusetts
Chelsea	Massachusetts
Everett	Massachusetts
Franklin	Massachusetts
Gardner	Massachusetts
Gloucester	Massachusetts
Greenfield	Massachusetts
Haverhill	Massachusetts
Holyoke	Massachusetts
Lawrence	Massachusetts
Leominster	Massachusetts
Lowell	Massachusetts
Lynn	Massachusetts
Malden	Massachusetts
Medford	Massachusetts
Melrose	Massachusetts
Methuen	Massachusetts
Newton	Massachusetts
Northampton	Massachusetts
Palmer	Massachusetts
Peabody	Massachusetts
Quincy	Massachusetts
Randolph	Massachusetts
Revere	Massachusetts
Salem	Massachusetts
Somerville	Massachusetts
Springfield	Massachusetts
Taunton	Massachusetts
Waltham	Massachusetts
Watertown	Massachusetts
Westfield	Massachusetts
Weymouth	Massachusetts
Winthrop	Massachusetts
Woburn	Massachusetts
Worcester	Massachusetts
Acme	Michigan
Addison	Michigan
Adrian	Michigan
Afton	Michigan
Akron	Michigan
Alba	Michigan
Albion	Michigan
Alden	Michigan
Alger	Michigan
Allen	Michigan
Alma	Michigan
Alpha	Michigan
Alto	Michigan
Applegate	Michigan
Arcadia	Michigan
Argentine	Michigan
Argyle	Michigan
Armada	Michigan
Arnold	Michigan
Ashley	Michigan
Athens	Michigan
Atlanta	Michigan
Atlas	Michigan
Attica	Michigan
Auburn	Michigan
Augusta	Michigan
Bailey	Michigan
Baldwin	Michigan
Bancroft	Michigan
Bangor	Michigan
Bannister	Michigan
Bath	Michigan
Beaverton	Michigan
Beecher	Michigan
Belding	Michigan
Belleville	Michigan
Bellevue	Michigan
Belmont	Michigan
Bentley	Michigan
Berkley	Michigan
Beulah	Michigan
Birmingham	Michigan
Blanchard	Michigan
Bloomingdale	Michigan
Boon	Michigan
Bradley	Michigan
Branch	Michigan
Brant	Michigan
Breckenridge	Michigan
Brethren	Michigan
Bridgeport	Michigan
Bridgewater	Michigan
Brighton	Michigan
Britton	Michigan
Bronson	Michigan
Brooklyn	Michigan
Brutus	Michigan
Buchanan	Michigan
Buckley	Michigan
Burlington	Michigan
Burt	Michigan
Burton	Michigan
Byron	Michigan
Cadillac	Michigan
Caledonia	Michigan
Calumet	Michigan
Camden	Michigan
Carney	Michigan
Caro	Michigan
Carrollton	Michigan
Caspian	Michigan
Cedar	Michigan
Champion	Michigan
Channing	Michigan
Charlotte	Michigan
Chase	Michigan
Chatham	Michigan
Chelsea	Michigan
Christmas	Michigan
Clare	Michigan
Clarksville	Michigan
Clawson	Michigan
Clayton	Michigan
Clifford	Michigan
Climax	Michigan
Clinton	Michigan
Clio	Michigan
Cloverdale	Michigan
Colon	Michigan
Columbus	Michigan
Commerce	Michigan
Comstock	Michigan
Concord	Michigan
Constantine	Michigan
Conway	Michigan
Coral	Michigan
Covert	Michigan
Covington	Michigan
Crump	Michigan
Curran	Michigan
Curtis	Michigan
Custer	Michigan
Daggett	Michigan
Davison	Michigan
Dearborn	Michigan
Decatur	Michigan
Decker	Michigan
Deerfield	Michigan
Detroit	Michigan
DeWitt	Michigan
Dexter	Michigan
Douglas	Michigan
Dowling	Michigan
Dryden	Michigan
Dublin	Michigan
Dundee	Michigan
Eagle	Michigan
Eastwood	Michigan
Ellsworth	Michigan
Elmira	Michigan
Elsie	Michigan
Emmett	Michigan
Empire	Michigan
Erie	Michigan
Eureka	Michigan
Farmington	Michigan
Farwell	Michigan
Fenton	Michigan
Ferndale	Michigan
Flint	Michigan
Flushing	Michigan
Forestville	Michigan
Fountain	Michigan
Fowler	Michigan
Frankfort	Michigan
Franklin	Michigan
Fraser	Michigan
Frederic	Michigan
Freeport	Michigan
Fremont	Michigan
Frontier	Michigan
Gaines	Michigan
Galesburg	Michigan
Garden	Michigan
Gaylord	Michigan
Gibraltar	Michigan
Gilford	Michigan
Gladstone	Michigan
Gladwin	Michigan
Glenn	Michigan
Glennie	Michigan
Goodrich	Michigan
Grant	Michigan
Greenland	Michigan
Greenville	Michigan
Gregory	Michigan
Gulliver	Michigan
Hadley	Michigan
Hale	Michigan
Hamburg	Michigan
Hamilton	Michigan
Hancock	Michigan
Hanover	Michigan
Haring	Michigan
Harris	Michigan
Harrison	Michigan
Hart	Michigan
Hartford	Michigan
Harvey	Michigan
Hastings	Michigan
Hell	Michigan
Hemlock	Michigan
Henderson	Michigan
Herron	Michigan
Hersey	Michigan
Hillman	Michigan
Holland	Michigan
Holly	Michigan
Holt	Michigan
Homer	Michigan
Honor	Michigan
Hope	Michigan
Hopkins	Michigan
Horton	Michigan
Houghton	Michigan
Howell	Michigan
Hubbell	Michigan
Hudson	Michigan
Ida	Michigan
Inkster	Michigan
Irons	Michigan
Ithaca	Michigan
Jackson	Michigan
Jamestown	Michigan
Jasper	Michigan
Jennings	Michigan
Johannesburg	Michigan
Kalamazoo	Michigan
Kendall	Michigan
Kenton	Michigan
Kimball	Michigan
Kingsley	Michigan
Kingston	Michigan
Lake	Michigan
Lakeland	Michigan
Lakeside	Michigan
Lakeview	Michigan
Lamont	Michigan
Lansing	Michigan
Lawrence	Michigan
Lawton	Michigan
Leland	Michigan
Lennon	Michigan
Leonard	Michigan
Leslie	Michigan
Lewiston	Michigan
Lexington	Michigan
Lincoln	Michigan
Linden	Michigan
Livonia	Michigan
Lowell	Michigan
Luther	Michigan
Lyons	Michigan
Macomb	Michigan
Manchester	Michigan
Marion	Michigan
Marquette	Michigan
Marshall	Michigan
Martin	Michigan
Marysville	Michigan
Mason	Michigan
McBride	Michigan
Mears	Michigan
Melvin	Michigan
Memphis	Michigan
Menominee	Michigan
Merrill	Michigan
Merritt	Michigan
Middleton	Michigan
Middletown	Michigan
Midland	Michigan
Milan	Michigan
Milford	Michigan
Mohawk	Michigan
Moline	Michigan
Monroe	Michigan
Montague	Michigan
Montgomery	Michigan
Montrose	Michigan
Moorestown	Michigan
Moran	Michigan
Morley	Michigan
Moscow	Michigan
Muir	Michigan
Munger	Michigan
Muskegon	Michigan
Napoleon	Michigan
Nashville	Michigan
Newberry	Michigan
Newport	Michigan
Niles	Michigan
Norway	Michigan
Novi	Michigan
Oakland	Michigan
Oakley	Michigan
Olivet	Michigan
Onondaga	Michigan
Orleans	Michigan
Oxford	Michigan
Palmer	Michigan
Palmyra	Michigan
Palo	Michigan
Paradise	Michigan
Parchment	Michigan
Paris	Michigan
Parma	Michigan
Peck	Michigan
Perry	Michigan
Petersburg	Michigan
Pickford	Michigan
Pierson	Michigan
Pigeon	Michigan
Pinckney	Michigan
Plymouth	Michigan
Pompeii	Michigan
Pontiac	Michigan
Portage	Michigan
Portland	Michigan
Powers	Michigan
Prescott	Michigan
Pullman	Michigan
Quincy	Michigan
Ralph	Michigan
Ramsay	Michigan
Ray	Michigan
Reading	Michigan
Reese	Michigan
Republic	Michigan
Rhodes	Michigan
Richland	Michigan
Richmond	Michigan
Ridgeway	Michigan
Riga	Michigan
Riverdale	Michigan
Riverside	Michigan
Riverview	Michigan
Rochester	Michigan
Rockford	Michigan
Rockland	Michigan
Rodney	Michigan
Rollin	Michigan
Romeo	Michigan
Romulus	Michigan
Roseville	Michigan
Ruby	Michigan
Rudyard	Michigan
Ruth	Michigan
Saginaw	Michigan
Salem	Michigan
Saline	Michigan
Samaria	Michigan
Sandusky	Michigan
Sanford	Michigan
Sawyer	Michigan
Sears	Michigan
Seneca	Michigan
Shelby	Michigan
Shepherd	Michigan
Sheridan	Michigan
Sherwood	Michigan
Shields	Michigan
Shoreham	Michigan
Smyrna	Michigan
Somerset	Michigan
Southfield	Michigan
Southgate	Michigan
Sparta	Michigan
Springfield	Michigan
Spruce	Michigan
Standish	Michigan
Stanton	Michigan
Stephenson	Michigan
Sterling	Michigan
Stockbridge	Michigan
Sumner	Michigan
Taylor	Michigan
Tecumseh	Michigan
Temperance	Michigan
Tipton	Michigan
Trenton	Michigan
Troy	Michigan
Turner	Michigan
Tustin	Michigan
Twining	Michigan
Union	Michigan
Utica	Michigan
Vandalia	Michigan
Vanderbilt	Michigan
Vassar	Michigan
Vernon	Michigan
Vicksburg	Michigan
Vulcan	Michigan
Waldron	Michigan
Walker	Michigan
Warren	Michigan
Waterford	Michigan
Waters	Michigan
Waverly	Michigan
Wayland	Michigan
Wayne	Michigan
Weidman	Michigan
Westwood	Michigan
Wheeler	Michigan
Whittaker	Michigan
Williamsburg	Michigan
Willis	Michigan
Winn	Michigan
Wixom	Michigan
Wolverine	Michigan
Woodhaven	Michigan
Woodland	Michigan
Wyoming	Michigan
Yale	Michigan
Ypsilanti	Michigan
Billings	Montana
Missoula	Montana
Bozeman	Montana
Butte	Montana
Helena	Montana
Belgrade	Montana
Livingston	Montana
Laurel	Montana
Whitefish	Montana
Lewistown	Montana
Sidney	Montana
Hamilton	Montana
Dillon	Montana
Hardin	Montana
Shelby	Montana
Glasgow	Montana
Libby	Montana
Conrad	Montana
Malta	Montana
Columbus	Montana
Townsend	Montana
Ronan	Montana
Roundup	Montana
Forsyth	Montana
Baker	Montana
Manhattan	Montana
Chinook	Montana
Boulder	Montana
Plains	Montana
Eureka	Montana
Browning	Montana
Troy	Montana
Chester	Montana
Ennis	Montana
Superior	Montana
Poplar	Montana
Harlem	Montana
Darby	Montana
Culbertson	Montana
Bridger	Montana
Fairfield	Montana
Cascade	Montana
Sheridan	Montana
Circle	Montana
Terry	Montana
Belt	Montana
Joliet	Montana
Geyser	Montana
Broadus	Montana
Stanford	Montana
Jordan	Montana
Dutton	Montana
Drummond	Montana
Nashua	Montana
Geraldine	Montana
Denton	Montana
Lima	Montana
Hobson	Montana
Winifred	Montana
Moore	Montana
Richey	Montana
Kevin	Montana
Dodson	Montana
Outlook	Montana
Omaha	Nebraska
Lincoln	Nebraska
Bellevue	Nebraska
Kearney	Nebraska
Fremont	Nebraska
Hastings	Nebraska
Norfolk	Nebraska
Columbus	Nebraska
Beatrice	Nebraska
Lexington	Nebraska
Alliance	Nebraska
Blair	Nebraska
York	Nebraska
Ralston	Nebraska
Crete	Nebraska
Seward	Nebraska
Sidney	Nebraska
Wayne	Nebraska
Gretna	Nebraska
Wahoo	Nebraska
Aurora	Nebraska
Waverly	Nebraska
Auburn	Nebraska
Minden	Nebraska
Valentine	Nebraska
Ashland	Nebraska
Kimball	Nebraska
Madison	Nebraska
Geneva	Nebraska
Milford	Nebraska
Imperial	Nebraska
Ord	Nebraska
Valley	Nebraska
Caliente	Nevada
Carlin	Nevada
Ely	Nevada
Fallon	Nevada
Henderson	Nevada
Mesquite	Nevada
Reno	Nevada
Sparks	Nevada
Wells	Nevada
Ada	Ohio
Akron	Ohio
Alliance	Ohio
Amherst	Ohio
Ashland	Ohio
Athens	Ohio
Aurora	Ohio
Avon	Ohio
Bedford	Ohio
Bellevue	Ohio
Berea	Ohio
Brooklyn	Ohio
Brunswick	Ohio
Bryan	Ohio
Cambridge	Ohio
Campbell	Ohio
Canfield	Ohio
Canton	Ohio
Carlisle	Ohio
Centerville	Ohio
Chillicothe	Ohio
Cincinnati	Ohio
Clayton	Ohio
Cleveland	Ohio
Clyde	Ohio
Columbus	Ohio
Dayton	Ohio
Defiance	Ohio
Delaware	Ohio
Dover	Ohio
Dublin	Ohio
Eaton	Ohio
Englewood	Ohio
Fairfield	Ohio
Findlay	Ohio
Franklin	Ohio
Fremont	Ohio
Geneva	Ohio
Germantown	Ohio
Girard	Ohio
Granville	Ohio
Green	Ohio
Greenfield	Ohio
Greenville	Ohio
Hamilton	Ohio
Harrison	Ohio
Heath	Ohio
Hilliard	Ohio
Hillsboro	Ohio
Hubbard	Ohio
Hudson	Ohio
Huron	Ohio
Independence	Ohio
Jackson	Ohio
Kent	Ohio
Kenton	Ohio
Kettering	Ohio
Lakewood	Ohio
Lancaster	Ohio
Lebanon	Ohio
Lima	Ohio
Logan	Ohio
London	Ohio
Lorain	Ohio
Louisville	Ohio
Loveland	Ohio
Macedonia	Ohio
Madeira	Ohio
Mansfield	Ohio
Marietta	Ohio
Marion	Ohio
Marysville	Ohio
Mason	Ohio
Medina	Ohio
Mentor	Ohio
Middletown	Ohio
Milford	Ohio
Monroe	Ohio
Montgomery	Ohio
Napoleon	Ohio
Newark	Ohio
Niles	Ohio
Norton	Ohio
Norwalk	Ohio
Norwood	Ohio
Oberlin	Ohio
Ontario	Ohio
Oregon	Ohio
Oxford	Ohio
Parma	Ohio
Portsmouth	Ohio
Powell	Ohio
Reading	Ohio
Riverside	Ohio
Salem	Ohio
Sandusky	Ohio
Shelby	Ohio
Sidney	Ohio
Springdale	Ohio
Springfield	Ohio
Stow	Ohio
Sylvania	Ohio
Toledo	Ohio
Toronto	Ohio
Trenton	Ohio
Troy	Ohio
Union	Ohio
Urbana	Ohio
Vandalia	Ohio
Vermilion	Ohio
Wadsworth	Ohio
Waterville	Ohio
Warren	Ohio
Waverly	Ohio
Westlake	Ohio
Willard	Ohio
Willoughby	Ohio
Wilmington	Ohio
Wooster	Ohio
Worthington	Ohio
Wyoming	Ohio
Youngstown	Ohio
Tulsa	Oklahoma
Norman	Oklahoma
Lawton	Oklahoma
Edmond	Oklahoma
Moore	Oklahoma
Enid	Oklahoma
Stillwater	Oklahoma
Muskogee	Oklahoma
Bartlesville	Oklahoma
Shawnee	Oklahoma
Ardmore	Oklahoma
Yukon	Oklahoma
Duncan	Oklahoma
Bixby	Oklahoma
Bethany	Oklahoma
Mustang	Oklahoma
McAlester	Oklahoma
Jenks	Oklahoma
Ada	Oklahoma
Durant	Oklahoma
Miami	Oklahoma
Woodward	Oklahoma
Choctaw	Oklahoma
Weatherford	Oklahoma
Guthrie	Oklahoma
Allentown	Pennsylvania
Altoona	Pennsylvania
Arnold	Pennsylvania
Bethlehem	Pennsylvania
Bradford	Pennsylvania
Butler	Pennsylvania
Carbondale	Pennsylvania
Chester	Pennsylvania
Corry	Pennsylvania
DuBois	Pennsylvania
Easton	Pennsylvania
Erie	Pennsylvania
Farrell	Pennsylvania
Franklin	Pennsylvania
Harrisburg	Pennsylvania
Hermitage	Pennsylvania
Jeannette	Pennsylvania
Johnstown	Pennsylvania
Lancaster	Pennsylvania
Lebanon	Pennsylvania
Monongahela	Pennsylvania
Parker	Pennsylvania
Philadelphia	Pennsylvania
Pittsburgh	Pennsylvania
Reading	Pennsylvania
Scranton	Pennsylvania
Sharon	Pennsylvania
Titusville	Pennsylvania
Uniontown	Pennsylvania
Warren	Pennsylvania
Washington	Pennsylvania
Williamsport	Pennsylvania
York	Pennsylvania
Adams	Tennessee
Alamo	Tennessee
Alcoa	Tennessee
Alexandria	Tennessee
Altamont	Tennessee
Ardmore	Tennessee
Arlington	Tennessee
Athens	Tennessee
Atwood	Tennessee
Bartlett	Tennessee
Baxter	Tennessee
Bells	Tennessee
Benton	Tennessee
Blaine	Tennessee
Bolivar	Tennessee
Braden	Tennessee
Bradford	Tennessee
Brentwood	Tennessee
Brighton	Tennessee
Bristol	Tennessee
Brownsville	Tennessee
Burns	Tennessee
Calhoun	Tennessee
Camden	Tennessee
Carthage	Tennessee
Centerville	Tennessee
Charleston	Tennessee
Charlotte	Tennessee
Chattanooga	Tennessee
Clarksville	Tennessee
Cleveland	Tennessee
Clifton	Tennessee
Clinton	Tennessee
Columbia	Tennessee
Covington	Tennessee
Cowan	Tennessee
Crump	Tennessee
Dayton	Tennessee
Decatur	Tennessee
Dickson	Tennessee
Dover	Tennessee
Doyle	Tennessee
Dresden	Tennessee
Dunlap	Tennessee
Dyer	Tennessee
Englewood	Tennessee
Erin	Tennessee
Erwin	Tennessee
Fayetteville	Tennessee
Finger	Tennessee
Franklin	Tennessee
Friendship	Tennessee
Gadsden	Tennessee
Garland	Tennessee
Gates	Tennessee
Gatlinburg	Tennessee
Germantown	Tennessee
Gibson	Tennessee
Gleason	Tennessee
Greenback	Tennessee
Greenbrier	Tennessee
Greeneville	Tennessee
Greenfield	Tennessee
Guys	Tennessee
Halls	Tennessee
Harriman	Tennessee
Henderson	Tennessee
Henning	Tennessee
Henry	Tennessee
Hornsby	Tennessee
Humboldt	Tennessee
Huntingdon	Tennessee
Huntsville	Tennessee
Jackson	Tennessee
Jamestown	Tennessee
Jasper	Tennessee
Kenton	Tennessee
Kimball	Tennessee
Kingston	Tennessee
Knoxville	Tennessee
Lafayette	Tennessee
LaGrange	Tennessee
Lakeland	Tennessee
Lakewood	Tennessee
Lebanon	Tennessee
Lewisburg	Tennessee
Lexington	Tennessee
Liberty	Tennessee
Linden	Tennessee
Livingston	Tennessee
Loudon	Tennessee
Louisville	Tennessee
Lynchburg	Tennessee
Madisonville	Tennessee
Manchester	Tennessee
Martin	Tennessee
Maryville	Tennessee
Mason	Tennessee
McEwen	Tennessee
McKenzie	Tennessee
Medina	Tennessee
Memphis	Tennessee
Middleton	Tennessee
Midtown	Tennessee
Milan	Tennessee
Monterey	Tennessee
Morrison	Tennessee
Morristown	Tennessee
Moscow	Tennessee
Nashville	Tennessee
Newport	Tennessee
Normandy	Tennessee
Norris	Tennessee
Oakland	Tennessee
Oneida	Tennessee
Palmer	Tennessee
Paris	Tennessee
Parsons	Tennessee
Petersburg	Tennessee
Philadelphia	Tennessee
Portland	Tennessee
Pulaski	Tennessee
Ripley	Tennessee
Rockford	Tennessee
Rutherford	Tennessee
Rutledge	Tennessee
Savannah	Tennessee
Sharon	Tennessee
Smyrna	Tennessee
Somerville	Tennessee
Sparta	Tennessee
Spencer	Tennessee
Springfield	Tennessee
Stanton	Tennessee
Sweetwater	Tennessee
Townsend	Tennessee
Trenton	Tennessee
Trimble	Tennessee
Troy	Tennessee
Viola	Tennessee
Walden	Tennessee
Watertown	Tennessee
Waverly	Tennessee
Waynesboro	Tennessee
Westmoreland	Tennessee
Winchester	Tennessee
Winfield	Tennessee
Woodbury	Tennessee
Houston	Texas
Dallas	Texas
Austin	Texas
Arlington	Texas
Plano	Texas
Laredo	Texas
Lubbock	Texas
Garland	Texas
Irving	Texas
Amarillo	Texas
Brownsville	Texas
Pasadena	Texas
Mesquite	Texas
McKinney	Texas
McAllen	Texas
Killeen	Texas
Waco	Texas
Carrollton	Texas
Frisco	Texas
Beaumont	Texas
Abilene	Texas
Denton	Texas
Midland	Texas
Odessa	Texas
Richardson	Texas
Tyler	Texas
Allen	Texas
Longview	Texas
Mission	Texas
Bryan	Texas
Temple	Texas
Victoria	Texas
Conroe	Texas
Mansfield	Texas
Rowlett	Texas
DeSoto	Texas
Georgetown	Texas
Galveston	Texas
Bedford	Texas
Grapevine	Texas
Wylie	Texas
Keller	Texas
Sherman	Texas
Huntsville	Texas
Hurst	Texas
Lancaster	Texas
Texarkana	Texas
Lufkin	Texas
Rosenberg	Texas
Waxahachie	Texas
Kyle	Texas
Leander	Texas
Alpine	Utah
Alta	Utah
Altamont	Utah
Alton	Utah
Annabella	Utah
Aurora	Utah
Ballard	Utah
Beaver	Utah
Boulder	Utah
Centerville	Utah
Charleston	Utah
Clawson	Utah
Cleveland	Utah
Clinton	Utah
Cornish	Utah
Daniel	Utah
Delta	Utah
Draper	Utah
Elmo	Utah
Elsinore	Utah
Elwood	Utah
Emery	Utah
Enoch	Utah
Enterprise	Utah
Ephraim	Utah
Escalante	Utah
Eureka	Utah
Fairfield	Utah
Farmington	Utah
Fielding	Utah
Fillmore	Utah
Francis	Utah
Garland	Utah
Glendale	Utah
Glenwood	Utah
Goshen	Utah
Gunnison	Utah
Hatch	Utah
Helper	Utah
Hideout	Utah
Highland	Utah
Hinckley	Utah
Holden	Utah
Hooper	Utah
Howell	Utah
Huntington	Utah
Huntsville	Utah
Hurricane	Utah
Independence	Utah
Ivins	Utah
Joseph	Utah
Junction	Utah
Kingston	Utah
Layton	Utah
Leeds	Utah
Lewiston	Utah
Logan	Utah
Lyman	Utah
Manila	Utah
Mayfield	Utah
Meadow	Utah
Midway	Utah
Milford	Utah
Millville	Utah
Moab	Utah
Mona	Utah
Monroe	Utah
Monticello	Utah
Morgan	Utah
Murray	Utah
Naples	Utah
Newton	Utah
Oakley	Utah
Ogden	Utah
Paradise	Utah
Perry	Utah
Plymouth	Utah
Portage	Utah
Price	Utah
Providence	Utah
Provo	Utah
Randolph	Utah
Redmond	Utah
Richfield	Utah
Richmond	Utah
Riverdale	Utah
Rockville	Utah
Roosevelt	Utah
Roy	Utah
Salem	Utah
Sandy	Utah
Scofield	Utah
Sigurd	Utah
Smithfield	Utah
Springdale	Utah
Sterling	Utah
Stockton	Utah
Sunset	Utah
Syracuse	Utah
Tooele	Utah
Torrey	Utah
Trenton	Utah
Tropic	Utah
Vernal	Utah
Vernon	Utah
Vineyard	Utah
Virgin	Utah
Wales	Utah
Washington	Utah
Wellington	Utah
Wendover	Utah
Willard	Utah
Woodruff	Utah
Burlington	Vermont
Barre	Vermont
Montpelier	Vermont
Newport	Vermont
Norfolk	Virginia
Chesapeake	Virginia
Richmond	Virginia
Alexandria	Virginia
Hampton	Virginia
Roanoke	Virginia
Portsmouth	Virginia
Suffolk	Virginia
Lynchburg	Virginia
Charlottesville	Virginia
Danville	Virginia
Manassas	Virginia
Petersburg	Virginia
Fredericksburg	Virginia
Winchester	Virginia
Salem	Virginia
Fairfax	Virginia
Hopewell	Virginia
Waynesboro	Virginia
Bristol	Virginia
Radford	Virginia
Williamsburg	Virginia
Martinsville	Virginia
Franklin	Virginia
Lexington	Virginia
Covington	Virginia
Emporia	Virginia
Norton	Virginia
Aberdeen	Washington
Arlington	Washington
Auburn	Washington
Bellevue	Washington
Bellingham	Washington
Bingen	Washington
Blaine	Washington
Bremerton	Washington
Brewster	Washington
Bridgeport	Washington
Brier	Washington
Buckley	Washington
Burlington	Washington
Carnation	Washington
Cashmere	Washington
Centralia	Washington
Chelan	Washington
Cheney	Washington
Colville	Washington
Connell	Washington
Covington	Washington
Davenport	Washington
Dayton	Washington
DuPont	Washington
Duvall	Washington
Edgewood	Washington
Edmonds	Washington
Everett	Washington
Everson	Washington
Ferndale	Washington
Fife	Washington
Forks	Washington
George	Washington
Grandview	Washington
Granger	Washington
Harrington	Washington
Kelso	Washington
Kenmore	Washington
Kent	Washington
Kirkland	Washington
Lacey	Washington
Lakewood	Washington
Langley	Washington
Leavenworth	Washington
Longview	Washington
Marysville	Washington
Medina	Washington
Mesa	Washington
Millwood	Washington
Milton	Washington
Monroe	Washington
Morton	Washington
Newcastle	Washington
Newport	Washington
Olympia	Washington
Othello	Washington
Pacific	Washington
Pasco	Washington
Pomeroy	Washington
Prescott	Washington
Pullman	Washington
Quincy	Washington
Rainier	Washington
Raymond	Washington
Redmond	Washington
Renton	Washington
Republic	Washington
Richland	Washington
Roslyn	Washington
Roy	Washington
Ruston	Washington
Seattle	Washington
Shelton	Washington
Shoreline	Washington
Snohomish	Washington
Spokane	Washington
Sprague	Washington
Stevenson	Washington
Sultan	Washington
Sumner	Washington
Tacoma	Washington
Toledo	Washington
Vader	Washington
Vancouver	Washington
Warden	Washington
Wenatchee	Washington
Westport	Washington
Woodland	Washington
Yakima	Washington
Adams	Wisconsin
Alma	Wisconsin
Altoona	Wisconsin
Appleton	Wisconsin
Arcadia	Wisconsin
Ashland	Wisconsin
Augusta	Wisconsin
Barron	Wisconsin
Berlin	Wisconsin
Blair	Wisconsin
Bloomer	Wisconsin
Brodhead	Wisconsin
Burlington	Wisconsin
Chilton	Wisconsin
Colby	Wisconsin
Columbus	Wisconsin
Cornell	Wisconsin
Cumberland	Wisconsin
Darlington	Wisconsin
Edgerton	Wisconsin
Elroy	Wisconsin
Evansville	Wisconsin
Franklin	Wisconsin
Gillett	Wisconsin
Glendale	Wisconsin
Greenfield	Wisconsin
Greenwood	Wisconsin
Hartford	Wisconsin
Hayward	Wisconsin
Hillsboro	Wisconsin
Hudson	Wisconsin
Hurley	Wisconsin
Independence	Wisconsin
Jefferson	Wisconsin
Juneau	Wisconsin
Kenosha	Wisconsin
Kiel	Wisconsin
Lancaster	Wisconsin
Lodi	Wisconsin
Loyal	Wisconsin
Madison	Wisconsin
Marion	Wisconsin
Marshfield	Wisconsin
Medford	Wisconsin
Merrill	Wisconsin
Middleton	Wisconsin
Milton	Wisconsin
Milwaukee	Wisconsin
Monroe	Wisconsin
Montreal	Wisconsin
Neenah	Wisconsin
Niagara	Wisconsin
Oshkosh	Wisconsin
Owen	Wisconsin
Phillips	Wisconsin
Plymouth	Wisconsin
Portage	Wisconsin
Prescott	Wisconsin
Princeton	Wisconsin
Racine	Wisconsin
Schofield	Wisconsin
Seymour	Wisconsin
Sparta	Wisconsin
Stanley	Wisconsin
Superior	Wisconsin
Thorp	Wisconsin
Tomahawk	Wisconsin
Verona	Wisconsin
Washburn	Wisconsin
Waterloo	Wisconsin
Watertown	Wisconsin
Waukesha	Wisconsin
Wausau	Wisconsin
Whitewater	Wisconsin
Afton	Wyoming
Albin	Wyoming
Alpine	Wyoming
Basin	Wyoming
Buffalo	Wyoming
Burlington	Wyoming
Burns	Wyoming
Byron	Wyoming
Casper	Wyoming
Cheyenne	Wyoming
Cody	Wyoming
Dayton	Wyoming
Dixon	Wyoming
Douglas	Wyoming
Dubois	Wyoming
Edgerton	Wyoming
Evanston	Wyoming
Evansville	Wyoming
Gillette	Wyoming
Granger	Wyoming
Hanna	Wyoming
Hudson	Wyoming
Jackson	Wyoming
Kirby	Wyoming
Lander	Wyoming
Laramie	Wyoming
Lovell	Wyoming
Lyman	Wyoming
Manville	Wyoming
Midwest	Wyoming
Mills	Wyoming
Newcastle	Wyoming
Opal	Wyoming
Powell	Wyoming
Rawlins	Wyoming
Riverside	Wyoming
Saratoga	Wyoming
Sheridan	Wyoming
Sinclair	Wyoming
Sundance	Wyoming
Superior	Wyoming
Torrington	Wyoming
Upton	Wyoming
Wright	Wyoming
Yoder	Wyoming