internal	internally
grateful	gratefully
bright	brightly
helpless	helplessly
oral	orally
contemporaneous	contemporaneously
approximate	approximately
enormous	enormously
lawful	lawfully
actual	actually
reliable	reliably
vain	vainly
simultaneous	simultaneously
hasty	hastily
succinct	succinctly
predictable	predictably
apt	aptly
stark	starkly
dutiful	dutifully
distinctive	distinctively
noticeable	noticeably
respectful	respectfully
blunt	bluntly
electoral	electorally
pleasant	pleasantly
conclusive	conclusively
instinctive	instinctively
amicable	amicably
digital	digitally
successful	successfully
great	greatly
diagonal	diagonally
correct	correctly
delightful	delightfully
justifiable	justifiably
feverish	feverishly
plausible	plausibly
passive	passively
ruthless	ruthlessly
essential	essentially
excellent	excellently
clinical	clinically
elder	elderly
unmistakable	unmistakably
loving	lovingly
aggressive	aggressively
intricate	intricately
sudden	suddenly
masterful	masterfully
brutal	brutally
hideous	hideously
automatic	automatically
improper	improperly
flexible	flexibly
exact	exactly
effortless	effortlessly
dear	dearly
peaceable	peaceably
obvious	obviously
admirable	admirably
incremental	incrementally
constant	constantly
biblical	biblically
acute	acutely
destructive	destructively
incessant	incessantly
careful	carefully
memorable	memorably
disastrous	disastrously
retroactive	retroactively
informal	informally
rational	rationally
measurable	measurably
playful	playfully
approving	approvingly
chief	chiefly
woeful	woefully
equitable	equitably
fortuitous	fortuitously
audible	audibly
quintessential	quintessentially
passionate	passionately
unilateral	unilaterally
awful	awfully
subconscious	subconsciously
prominent	prominently
tender	tenderly
guarded	guardedly
stiff	stiffly
abundant	abundantly
fine	finely
conspicuous	conspicuously
cool	coolly
military	militarily
sparse	sparsely
wise	wisely
analytical	analytically
flamboyant	flamboyantly
terminal	terminally
spectacular	spectacularly
developmental	developmentally
judicial	judicially
alternative	alternatively
selective	selectively
artificial	artificially
explicit	explicitly
equal	equally
relentless	relentlessly
oblique	obliquely
earnest	earnestly
silent	silently
superb	superbly
abnormal	abnormally
global	globally
ample	amply
qualitative	qualitatively
belated	belatedly
avid	avidly
conservative	conservatively
absolute	absolutely
cynical	cynically
heavy	heavily
extreme	extremely
calm	calmly
crude	crudely
impulsive	impulsively
unhappy	unhappily
vocal	vocally
bare	barely
unacceptable	unacceptably
instantaneous	instantaneously
graphical	graphically
grave	gravely
even	evenly
inexpensive	inexpensively
ecological	ecologically
deserved	deservedly
flat	flatly
cold	coldly
undoubted	undoubtedly
tacit	tacitly
commercial	commercially
neutral	neutrally
grotesque	grotesquely
evident	evidently
inappropriate	inappropriately
magnificent	magnificently
reckless	recklessly
grammatical	grammatically
superficial	superficially
biological	biologically
collaborative	collaboratively
corresponding	correspondingly
racial	racially
active	actively
cautious	cautiously
minute	minutely
ferocious	ferociously
eminent	eminently
stout	stoutly
astonishing	astonishingly
critical	critically
prohibitive	prohibitively
adamant	adamantly
candid	candidly
casual	casually
entire	entirely
modest	modestly
industrial	industrially
conscious	consciously
demonstrable	demonstrably
fraudulent	fraudulently
sweet	sweetly
horrible	horribly
bizarre	bizarrely
perpetual	perpetually
defiant	defiantly
sexual	sexually
triumphant	triumphantly
conscientious	conscientiously
figurative	figuratively
tenacious	tenaciously
eventual	eventually
bitter	bitterly
central	centrally
educational	educationally
according	accordingly
cheap	cheaply
patient	patiently
arrogant	arrogantly
slow	slowly
secondary	secondarily
external	externally
unambiguous	unambiguously
uncomfortable	uncomfortably
unique	uniquely
covert	covertly
criminal	criminally
rigid	rigidly
intuitive	intuitively
good	goodly
solid	solidly
embarrassing	embarrassingly
inadequate	inadequately
noisy	noisily
emotional	emotionally
bold	boldly
financial	financially
credible	credibly
interchangeable	interchangeably
incorrect	incorrectly
annual	annually
avowed	avowedly
happy	happily
convincing	convincingly
steady	steadily
irreparable	irreparably
implicit	implicitly
quiet	quietly
purposeful	purposefully
electrical	electrically
gracious	graciously
startling	startlingly
false	falsely
unsuccessful	unsuccessfully
wary	warily
fatal	fatally
careless	carelessly
profitable	profitably
federal	federally
deceptive	deceptively
wry	wryly
resolute	resolutely
attractive	attractively
loyal	loyally
splendid	splendidly
irrevocable	irrevocably
ridiculous	ridiculously
selfless	selflessly
erroneous	erroneously
vivid	vividly
mistaken	mistakenly
alleged	allegedly
concrete	concretely
express	expressly
retrospective	retrospectively
notorious	notoriously
hot	hotly
reluctant	reluctantly
intellectual	intellectually
reflexive	reflexively
shameless	shamelessly
zealous	zealously
contractual	contractually
joyful	joyfully
bilateral	bilaterally
exquisite	exquisitely
unwise	unwisely
chronological	chronologically
anecdotal	anecdotally
exhaustive	exhaustively
anatomical	anatomically
scrupulous	scrupulously
extensive	extensively
irreversible	irreversibly
usual	usually
cheerful	cheerfully
eager	eagerly
vicarious	vicariously
glad	gladly
faithful	faithfully
premature	prematurely
unjustifiable	unjustifiably
manifest	manifestly
mysterious	mysteriously
massive	massively
menacing	menacingly
vicious	viciously
intentional	intentionally
stunning	stunningly
subjective	subjectively
elaborate	elaborately
fractional	fractionally
lavish	lavishly
operational	operationally
continual	continually
naive	naively
powerful	powerfully
phenomenal	phenomenally
conventional	conventionally
broad	broadly
structural	structurally
artful	artfully
impressive	impressively
grievous	grievously
loose	loosely
attentive	attentively
hard	hardly
fierce	fiercely
offensive	offensively
impassive	impassively
collective	collectively
unpredictable	unpredictably
sensitive	sensitively
confident	confidently
competent	competently
dead	deadly
concurrent	concurrently
gallant	gallantly
rightful	rightfully
decent	decently
general	generally
indisputable	indisputably
steep	steeply
distinct	distinctly
harsh	harshly
illegal	illegally
proud	proudly
clean	cleanly
additional	additionally
indirect	indirectly
horizontal	horizontally
negligent	negligently
lucky	luckily
alternate	alternately
safe	safely
legitimate	legitimately
eternal	eternally
savage	savagely
constitutional	constitutionally
tearful	tearfully
dismal	dismally
discreet	discreetly
rigorous	rigorously
considerable	considerably
unwilling	unwillingly
integral	integrally
blissful	blissfully
haphazard	haphazardly
accurate	accurately
authoritative	authoritatively
unnatural	unnaturally
third	thirdly
variable	variably
gradual	gradually
unreasonable	unreasonably
productive	productively
manual	manually
satisfactory	satisfactorily
eloquent	eloquently
staunch	staunchly
keen	keenly
proportionate	proportionately
dogged	doggedly
frank	frankly
consequent	consequently
faint	faintly
loud	loudly
subtle	subtly
harmonious	harmoniously
vigorous	vigorously
vociferous	vociferously
resounding	resoundingly
coincidental	coincidentally
constructive	constructively
verbal	verbally
tremendous	tremendously
aimless	aimlessly
infrequent	infrequently
angry	angrily
meek	meekly
innate	innately
tight	tightly
peaceful	peacefully
regional	regionally
exceeding	exceedingly
alphabetical	alphabetically
spontaneous	spontaneously
deft	deftly
comprehensive	comprehensively
conceivable	conceivably
random	randomly
ambiguous	ambiguously
governmental	governmentally
firm	firmly
sequential	sequentially
inexorable	inexorably
most	mostly
unconditional	unconditionally
malicious	maliciously
discrete	discretely
handy	handily
irresponsible	irresponsibly
direct	directly
pejorative	pejoratively
administrative	administratively
comical	comically
curious	curiously
insane	insanely
imminent	imminently
unavoidable	unavoidably
defensive	defensively
brilliant	brilliantly
fluent	fluently
awkward	awkwardly
different	differently
unbelievable	unbelievably
admitted	admittedly
occasional	occasionally
inaccurate	inaccurately
competitive	competitively
irregular	irregularly
harmless	harmlessly
diligent	diligently
meaningful	meaningfully
perverse	perversely
immeasurable	immeasurably
final	finally
maximal	maximally
factual	factually
hurried	hurriedly
joint	jointly
apparent	apparently
cognitive	cognitively
impeccable	impeccably
involuntary	involuntarily
continuous	continuously
ceaseless	ceaselessly
snug	snugly
universal	universally
forceful	forcefully
a	aly
secret	secretly
truthful	truthfully
huge	hugely
inward	inwardly
corrupt	corruptly
intermittent	intermittently
appreciable	appreciably
clear	clearly
shocking	shockingly
fearless	fearlessly
unjust	unjustly
convenient	conveniently
merciless	mercilessly
definite	definitely
bad	badly
explosive	explosively
famous	famously
intravenous	intravenously
seamless	seamlessly
brief	briefly
stubborn	stubbornly
miraculous	miraculously
deliberate	deliberately
consistent	consistently
extravagant	extravagantly
gross	grossly
adequate	adequately
stern	sternly
perennial	perennially
free	freely
unexpected	unexpectedly
elegant	elegantly
tangential	tangentially
steadfast	steadfastly
intense	intensely
coherent	coherently
intensive	intensively
fond	fondly
surreptitious	surreptitiously
idle	idly
nutritional	nutritionally
generous	generously
vehement	vehemently
fitting	fittingly
unintentional	unintentionally
typical	typically
fair	fairly
nervous	nervously
high	highly
negative	negatively
precipitous	precipitously
unknowing	unknowingly
basic	basically
first	firstly
uneven	unevenly
fundamental	fundamentally
inherent	inherently
exclusive	exclusively
neat	neatly
formal	formally
unequal	unequally
tireless	tirelessly
consecutive	consecutively
disturbing	disturbingly
precarious	precariously
cruel	cruelly
conceptual	conceptually
deep	deeply
fabulous	fabulously
unfortunate	unfortunately
intelligent	intelligently
persistent	persistently
frustrating	frustratingly
efficient	efficiently
dense	densely
thoughtful	thoughtfully
urgent	urgently
fresh	freshly
sensible	sensibly
unfair	unfairly
brave	bravely
uneasy	uneasily
rare	rarely
appropriate	appropriately
ideal	ideally
fantastical	fantastically
humane	humanely
unanimous	unanimously
devout	devoutly
understandable	understandably
alarming	alarmingly
just	justly
possible	possibly
obsessive	obsessively
proportional	proportionally
fortunate	fortunately
intimate	intimately
outrageous	outrageously
close	closely
crucial	crucially
traditional	traditionally
overwhelming	overwhelmingly
separate	separately
inverse	inversely
polite	politely
weak	weakly
dangerous	dangerously
shrewd	shrewdly
conditional	conditionally
fervent	fervently
anxious	anxiously
dim	dimly
empirical	empirically
unconstitutional	unconstitutionally
cordial	cordially
overt	overtly
rash	rashly
classical	classically
repetitive	repetitively
accidental	accidentally
virulent	virulently
derisive	derisively
beautiful	beautifully
peripheral	peripherally
desperate	desperately
tentative	tentatively
immediate	immediately
certain	certainly
posthumous	posthumously
amazing	amazingly
serious	seriously
provisional	provisionally
habitual	habitually
wrongful	wrongfully
swift	swiftly
exponential	exponentially
ethical	ethically
useful	usefully
robust	robustly
needless	needlessly
furious	furiously
strenuous	strenuously
editorial	editorially
unconscious	unconsciously
soft	softly
meticulous	meticulously
rude	rudely
strange	strangely
lateral	laterally
exceptional	exceptionally
studious	studiously
ginger	gingerly
common	commonly
abstract	abstractly
concise	concisely
inexplicable	inexplicably
frequent	frequently
disparaging	disparagingly
quick	quickly
progressive	progressively
hilarious	hilariously
adverse	adversely
dark	darkly
excessive	excessively
expensive	expensively
ardent	ardently
speedy	speedily
delicate	delicately
astronomical	astronomically
ominous	ominously
handsome	handsomely
undeniable	undeniably
invisible	invisibly
minimal	minimally
abrupt	abruptly
royal	royally
assiduous	assiduously
current	currently
indiscriminate	indiscriminately
dishonest	dishonestly
former	formerly
courageous	courageously
clandestine	clandestinely
endless	endlessly
foolish	foolishly
provocative	provocatively
affectionate	affectionately
improbable	improbably
precise	precisely
creative	creatively
effective	effectively
impossible	impossibly
decisive	decisively
converse	conversely
functional	functionally
absurd	absurdly
categorical	categorically
definitive	definitively
environmental	environmentally
social	socially
ritual	ritually
unofficial	unofficially
poignant	poignantly
scanty	scantily
grim	grimly
disproportionate	disproportionately
miserable	miserably
profound	profoundly
innocent	innocently
clumsy	clumsily
transparent	transparently
cultural	culturally
flawless	flawlessly
complete	completely
morbid	morbidly
graceful	gracefully
experimental	experimentally
anonymous	anonymously
beneficial	beneficially
laborious	laboriously
blatant	blatantly
excited	excitedly
humorous	humorously
humble	humbly
impatient	impatiently
cumulative	cumulatively
smart	smartly
decided	decidedly
geographical	geographically
eerie	eerily
painstaking	painstakingly
contemptuous	contemptuously
imperfect	imperfectly
sufficient	sufficiently
blind	blindly
insufficient	insufficiently
intent	intently
mental	mentally
fiscal	fiscally
expert	expertly
sensational	sensationally
divine	divinely
solemn	solemnly
facetious	facetiously
economical	economically
independent	independently
irrational	irrationally
impartial	impartially
unlawful	unlawfully
brisk	briskly
rapid	rapidly
comparative	comparatively
willing	willingly
quantitative	quantitatively
clever	cleverly
professional	professionally
genuine	genuinely
