bask	basking
spy	spying
vent	venting
regain	regaining
elbow	elbowing
instigate	instigating
worsen	worsening
demoralize	demoralizing
diverge	diverging
view	viewing
evoke	evoking
venture	venturing
leave	leaving
fluctuate	fluctuating
translate	translating
recall	recalling
replay	replaying
prove	proving
shorten	shortening
override	overriding
solidify	solidifying
kill	killing
flame	flaming
mastermind	masterminding
pose	posing
whale	whaling
worship	worshipping
typecast	typecasting
relax	relaxing
ratify	ratifying
juggle	juggling
note	noting
condition	conditioning
examine	examining
rove	roving
ferment	fermenting
liquidate	liquidating
inhabit	inhabiting
finger	fingering
sprawl	sprawling
plumb	plumbing
replace	replacing
exaggerate	exaggerating
tutor	tutoring
petition	petitioning
cop	coping
dazzle	dazzling
truck	trucking
augment	augmenting
tower	towering
erode	eroding
case	casing
dislike	disliking
bicycle	bicycling
flop	flopping
fly	flying
incriminate	incriminating
stunt	stunting
scatter	scattering
experience	experiencing
sabotage	sabotaging
attend	attending
approximate	approximating
revoke	revoking
acknowledge	acknowledging
detail	detailing
overheat	overheating
snort	snorting
expend	expending
submerge	submerging
isolate	isolating
number	numbering
claw	clawing
fell	felling
kick	kicking
condone	condoning
mutter	muttering
boycott	boycotting
liberalize	liberalizing
exit	exiting
happen	happening
pool	pooling
establish	establishing
hope	hoping
grow	growing
model	modeling
scorch	scorching
interpret	interpreting
leap	leaping
seem	seeming
loot	looting
report	reporting
bloom	blooming
drive	driving
fortify	fortifying
telephone	telephoning
betray	betraying
hoist	hoisting
reproduce	reproducing
parachute	parachuting
brief	briefing
dock	docking
lodge	lodging
eke	eking
rear	rearing
reconsider	reconsidering
retrieve	retrieving
star	staring
stuff	stuffing
grumble	grumbling
earn	earning
puff	puffing
nudge	nudging
present	presenting
phrase	phrasing
perfect	perfecting
temper	tempering
trust	trusting
snatch	snatching
suspend	suspending
toy	toying
box	boxing
shell	shelling
secure	securing
gobble	gobbling
chant	chanting
snipe	sniping
drag	dragging
sniff	sniffing
trick	tricking
whoop	whooping
fax	faxing
scrape	scraping
exercise	exercising
provoke	provoking
headline	headlining
dial	dialing
hum	humming
affirm	affirming
sterilize	sterilizing
expand	expanding
tail	tailing
fragment	fragmenting
intersect	intersecting
echo	echoing
bore	boring
book	booking
trap	trapping
utilize	utilizing
keep	keeping
animate	animating
compile	compiling
spawn	spawning
obliterate	obliterating
remember	remembering
stomp	stomping
dip	dipping
admire	admiring
lick	licking
describe	describing
zone	zoning
train	training
sit	sitting
meander	meandering
damage	damaging
overwhelm	overwhelming
cushion	cushioning
debut	debuting
sue	suing
arrest	arresting
team	teaming
conquer	conquering
expedite	expediting
level	leveling
crown	crowning
mingle	mingling
centralize	centralizing
freak	freaking
choreograph	choreographing
overdose	overdosing
update	updating
trim	trimming
warn	warning
prod	prodding
dissent	dissenting
sag	sagging
unwind	unwinding
rule	ruling
defraud	defrauding
order	ordering
subtract	subtracting
impair	impairing
overreact	overreacting
equal	equaling
travel	travelling
disappoint	disappointing
strangle	strangling
consist	consisting
diffuse	diffusing
route	routing
nest	nesting
provide	providing
last	lasting
infuse	infusing
recharge	recharging
stimulate	stimulating
obtain	obtaining
restrain	restraining
borrow	borrowing
dump	dumping
tarnish	tarnishing
confirm	confirming
discharge	discharging
adore	adoring
brush	brushing
eat	eating
deepen	deepening
install	installing
impede	impeding
shift	shifting
total	totaling
frame	framing
detain	detaining
use	using
arm	arming
undergo	undergoing
tape	taping
ingest	ingesting
recruit	recruiting
wield	wielding
ground	grounding
propagate	propagating
crawl	crawling
spring	springing
campaign	campaigning
defame	defaming
seize	seizing
extrapolate	extrapolating
mow	mowing
prohibit	prohibiting
dawn	dawning
ensure	ensuring
encompass	encompassing
bankroll	bankrolling
clock	clocking
curb	curbing
harvest	harvesting
brand	branding
signify	signifying
embrace	embracing
amend	amending
chip	chipping
explain	explaining
mutilate	mutilating
fume	fuming
rein	reining
pander	pandering
peak	peaking
confide	confiding
hook	hooking
pertain	pertaining
resurface	resurfacing
assault	assaulting
snake	snaking
fatten	fattening
frequent	frequenting
gallop	galloping
bargain	bargaining
brim	brimming
generate	generating
battle	battling
mediate	mediating
triple	tripling
filter	filtering
deflate	deflating
convict	convicting
release	releasing
pave	paving
emulate	emulating
muse	musing
promise	promising
graft	grafting
mix	mixing
reward	rewarding
depreciate	depreciating
feature	featuring
curtail	curtailing
communicate	communicating
commit	committing
forecast	forecasting
stagger	staggering
accrue	accruing
corroborate	corroborating
dredge	dredging
achieve	achieving
stiffen	stiffening
advertise	advertising
groan	groaning
seed	seeding
resume	resuming
nominate	nominating
reckon	reckoning
mutate	mutating
model	modelling
break	breaking
mistake	mistaking
rap	raping
overpower	overpowering
accommodate	accommodating
compliment	complimenting
merge	merging
stutter	stuttering
express	expressing
constitute	constituting
cooperate	cooperating
lob	lobbing
clot	clotting
tour	touring
eliminate	eliminating
transplant	transplanting
chase	chasing
lap	lapping
warm	warming
assemble	assembling
net	netting
slow	slowing
seep	seeping
glaze	glazing
plug	plugging
overlap	overlapping
quicken	quickening
launder	laundering
sport	sporting
settle	settling
celebrate	celebrating
babble	babbling
occupy	occupying
burn	burning
interfere	interfering
fake	faking
chair	chairing
bounce	bouncing
steady	steadying
comb	combing
adapt	adapting
halt	halting
neglect	neglecting
listen	listening
leach	leaching
tow	towing
overflow	overflowing
mother	mothering
skim	skimming
desire	desiring
nurture	nurturing
overfly	overflying
spell	spelling
resurrect	resurrecting
catalogue	cataloguing
veto	vetoing
engineer	engineering
implant	implanting
cause	causing
slot	slotting
monitor	monitoring
exceed	exceeding
will	willing
lobby	lobbying
round	rounding
defect	defecting
humiliate	humiliating
worry	worrying
consent	consenting
partition	partitioning
commute	commuting
boil	boiling
define	defining
contaminate	contaminating
unleash	unleashing
stipulate	stipulating
humble	humbling
part	parting
prime	priming
substitute	substituting
shun	shunning
couple	coupling
bomb	bombing
lessen	lessening
found	founding
cure	curing
indict	indicting
lumber	lumbering
convince	convincing
structure	structuring
sink	sinking
dust	dusting
salvage	salvaging
pan	panning
foment	fomenting
show	showing
hobble	hobbling
handicap	handicapping
blink	blinking
buzz	buzzing
commission	commissioning
explode	exploding
tread	treading
frighten	frightening
vow	vowing
combat	combating
struggle	struggling
flip	flipping
elude	eluding
exempt	exempting
overlay	overlaying
nap	napping
well	welling
tool	tooling
precipitate	precipitating
maximize	maximizing
sleep	sleeping
damn	damning
chat	chatting
grasp	grasping
drone	droning
appeal	appealing
allocate	allocating
ripen	ripening
store	storing
cascade	cascading
hole	holing
allude	alluding
infer	inferring
worship	worshiping
hone	honing
mushroom	mushrooming
strum	strumming
retire	retiring
rename	renaming
rejoice	rejoicing
prejudice	prejudicing
fish	fishing
mend	mending
mature	maturing
water	watering
resettle	resettling
rework	reworking
slash	slashing
shower	showering
weaken	weakening
specialize	specializing
bow	bowing
jostle	jostling
diagnose	diagnosing
relay	relaying
force	forcing
edit	editing
tighten	tightening
charge	charging
license	licensing
debate	debating
aspire	aspiring
load	loading
polish	polishing
scrap	scrapping
pattern	patterning
save	saving
suffocate	suffocating
pardon	pardoning
plot	plotting
liberate	liberating
languish	languishing
flake	flaking
gossip	gossiping
hustle	hustling
abdicate	abdicating
realign	realigning
suggest	suggesting
separate	separating
hollow	hollowing
warrant	warranting
dispel	dispelling
chronicle	chronicling
clinch	clinching
eradicate	eradicating
dismiss	dismissing
bank	banking
floor	flooring
pad	padding
propose	proposing
distribute	distributing
owe	owing
extinguish	extinguishing
hurt	hurting
comfort	comforting
intimidate	intimidating
uproot	uprooting
further	furthering
direct	directing
regard	regarding
probe	probing
reflect	reflecting
obstruct	obstructing
puzzle	puzzling
shred	shredding
wind	winding
irritate	irritating
rampage	rampaging
police	policing
inhibit	inhibiting
pirate	pirating
border	bordering
dwindle	dwindling
perish	perishing
rub	rubbing
chop	chopping
shade	shading
recur	recurring
drown	drowning
marshal	marshalling
swear	swearing
reply	replying
request	requesting
enforce	enforcing
better	bettering
jar	jarring
spray	spraying
cook	cooking
suit	suiting
stack	stacking
waver	wavering
unseat	unseating
straddle	straddling
curve	curving
ascertain	ascertaining
withstand	withstanding
smelt	smelting
observe	observing
confiscate	confiscating
censor	censoring
rap	rapping
counterfeit	counterfeiting
postpone	postponing
skin	skinning
pile	piling
gravitate	gravitating
erupt	erupting
reveal	revealing
amount	amounting
jockey	jockeying
heed	heeding
limp	limping
want	wanting
change	changing
frost	frosting
overrun	overrunning
waltz	waltzing
stone	stoning
peep	peeping
diet	dieting
churn	churning
skid	skidding
shed	shedding
prospect	prospecting
mount	mounting
babysit	babysitting
factor	factoring
cease	ceasing
school	schooling
incapacitate	incapacitating
abet	abetting
paraphrase	paraphrasing
circumvent	circumventing
overload	overloading
deduct	deducting
choke	choking
decelerate	decelerating
accentuate	accentuating
club	clubbing
avenge	avenging
incubate	incubating
hatch	hatching
devour	devouring
race	racing
tunnel	tunneling
slander	slandering
qualify	qualifying
apologize	apologizing
deteriorate	deteriorating
total	totalling
heighten	heightening
front	fronting
lead	leading
converse	conversing
downgrade	downgrading
access	accessing
descend	descending
snow	snowing
discern	discerning
manipulate	manipulating
play	playing
silence	silencing
dissipate	dissipating
despair	despairing
mail	mailing
chalk	chalking
refresh	refreshing
authorize	authorizing
bestow	bestowing
thunder	thundering
deserve	deserving
manufacture	manufacturing
muddle	muddling
safeguard	safeguarding
reopen	reopening
gauge	gauging
recount	recounting
rough	roughing
violate	violating
unite	uniting
drug	drugging
minister	ministering
posit	positing
respect	respecting
rattle	rattling
lack	lacking
amuse	amusing
feel	feeling
spotlight	spotlighting
lure	luring
disconnect	disconnecting
reissue	reissuing
toll	tolling
lament	lamenting
flounder	floundering
face	facing
champion	championing
redeem	redeeming
differentiate	differentiating
overrule	overruling
place	placing
dedicate	dedicating
initiate	initiating
slam	slamming
gush	gushing
obey	obeying
retail	retailing
annoy	annoying
evolve	evolving
grab	grabbing
hesitate	hesitating
lop	lopping
reference	referencing
label	labelling
jump	jumping
wage	waging
award	awarding
father	fathering
draw	drawing
complicate	complicating
foreshadow	foreshadowing
summarize	summarizing
drop	dropping
condemn	condemning
retreat	retreating
treat	treating
carve	carving
lash	lashing
shock	shocking
furnish	furnishing
kidnap	kidnapping
redress	redressing
lengthen	lengthening
met	meting
reserve	reserving
induce	inducing
sponsor	sponsoring
recognize	recognizing
distrust	distrusting
nibble	nibbling
balloon	ballooning
coast	coasting
wear	wearing
project	projecting
plunge	plunging
electrify	electrifying
abort	aborting
stow	stowing
bully	bullying
grade	grading
short	shorting
molest	molesting
sit	siting
leak	leaking
automate	automating
account	accounting
consult	consulting
avert	averting
coalesce	coalescing
persuade	persuading
scrutinize	scrutinizing
succumb	succumbing
bungle	bungling
ruin	ruining
unnerve	unnerving
disobey	disobeying
stumble	stumbling
signal	signalling
align	aligning
plan	planning
presume	presuming
sprout	sprouting
stain	staining
standardize	standardizing
produce	producing
increase	increasing
game	gaming
crop	cropping
cry	crying
whip	whipping
pick	picking
simmer	simmering
hibernate	hibernating
erect	erecting
railroad	railroading
swirl	swirling
immerse	immersing
detonate	detonating
pocket	pocketing
thrive	thriving
ration	rationing
hinder	hindering
end	ending
deny	denying
divert	diverting
gag	gagging
mold	molding
wake	waking
rain	raining
beam	beaming
log	logging
dot	dotting
black	blacking
dabble	dabbling
engulf	engulfing
roast	roasting
heal	healing
camp	camping
clone	cloning
close	closing
fall	falling
rifle	rifling
resolve	resolving
yield	yielding
menace	menacing
tattoo	tattooing
buckle	buckling
toot	tooting
constrict	constricting
soften	softening
slap	slapping
screen	screening
touch	touching
grate	grating
counsel	counseling
prey	preying
unload	unloading
cruise	cruising
loathe	loathing
erase	erasing
assume	assuming
tamper	tampering
measure	measuring
escape	escaping
mark	marking
lapse	lapsing
satirize	satirizing
hare	haring
abstain	abstaining
mitigate	mitigating
desert	deserting
realize	realizing
launch	launching
stamp	stamping
tinker	tinkering
ripple	rippling
summon	summoning
hide	hiding
rage	raging
protest	protesting
resemble	resembling
curse	cursing
list	listing
clump	clumping
romance	romancing
benchmark	benchmarking
snap	snapping
trouble	troubling
convert	converting
trample	trampling
offset	offsetting
determine	determining
storm	storming
destabilize	destabilizing
injure	injuring
relate	relating
circle	circling
restate	restating
retaliate	retaliating
reassure	reassuring
amass	amassing
block	blocking
compose	composing
transcribe	transcribing
consume	consuming
wave	waving
retrench	retrenching
redouble	redoubling
air	airing
retrace	retracing
nag	nagging
growl	growling
contain	containing
braid	braiding
steer	steering
host	hosting
pen	penning
saw	sawing
exist	existing
point	pointing
fuel	fueling
pry	prying
aid	aiding
distill	distilling
lay	laying
entice	enticing
relapse	relapsing
decide	deciding
herald	heralding
discount	discounting
program	programming
flatten	flattening
pressure	pressuring
emphasize	emphasizing
preach	preaching
frustrate	frustrating
underestimate	underestimating
rebound	rebounding
ram	ramming
accomplish	accomplishing
brace	bracing
retract	retracting
demolish	demolishing
meld	melding
shelter	sheltering
unsettle	unsettling
sketch	sketching
seat	seating
ridicule	ridiculing
appreciate	appreciating
figure	figuring
put	putting
push	pushing
sip	sipping
alienate	alienating
commence	commencing
recreate	recreating
mass	massing
underlie	underlying
partake	partaking
bust	busting
begin	beginning
grunt	grunting
please	pleasing
issue	issuing
balance	balancing
deal	dealing
avoid	avoiding
migrate	migrating
prescribe	prescribing
trigger	triggering
reunify	reunifying
tank	tanking
deviate	deviating
disrupt	disrupting
knit	knitting
represent	representing
murder	murdering
stall	stalling
right	righting
instruct	instructing
identify	identifying
jerk	jerking
pin	pining
defy	defying
tack	tacking
hawk	hawking
authenticate	authenticating
fool	fooling
nail	nailing
decrease	decreasing
mobilize	mobilizing
center	centering
post	posting
thump	thumping
file	filing
ignore	ignoring
soothe	soothing
canvass	canvassing
ally	allying
misrepresent	misrepresenting
wire	wiring
diversify	diversifying
locate	locating
supplement	supplementing
overstate	overstating
reappear	reappearing
service	servicing
preclude	precluding
enjoy	enjoying
brake	braking
tap	tapping
redeploy	redeploying
socialize	socializing
reminisce	reminiscing
alarm	alarming
profess	professing
whistle	whistling
glide	gliding
annihilate	annihilating
chirp	chirping
expect	expecting
smuggle	smuggling
relieve	relieving
preview	previewing
slope	sloping
perpetrate	perpetrating
shoulder	shouldering
thin	thinning
chain	chaining
attack	attacking
draft	drafting
resign	resigning
prop	propping
sap	sapping
pilot	piloting
invent	inventing
melt	melting
earmark	earmarking
captivate	captivating
divorce	divorcing
normalize	normalizing
map	mapping
accuse	accusing
skate	skating
impress	impressing
infuriate	infuriating
taunt	taunting
cool	cooling
trip	tripping
import	importing
rise	rising
grant	granting
depart	departing
brawl	brawling
vanish	vanishing
love	loving
forgive	forgiving
bide	biding
sight	sighting
carpet	carpeting
cultivate	cultivating
tie	tying
disburse	disbursing
slip	slipping
vie	vying
effect	effecting
bake	baking
depict	depicting
narrow	narrowing
divulge	divulging
advocate	advocating
reconcile	reconciling
invade	invading
prowl	prowling
magnify	magnifying
mate	mating
dart	darting
embarrass	embarrassing
whirl	whirling
flower	flowering
impinge	impinging
transform	transforming
overcharge	overcharging
mandate	mandating
site	siting
surprise	surprising
forbid	forbidding
reconstruct	reconstructing
exhibit	exhibiting
card	carding
feign	feigning
concur	concurring
stand	standing
usher	ushering
pump	pumping
reinforce	reinforcing
cash	cashing
converge	converging
founder	foundering
devastate	devastating
give	giving
wag	waging
possess	possessing
cast	casting
bear	bearing
sandbag	sandbagging
submit	submitting
soak	soaking
throttle	throttling
fire	firing
pounce	pouncing
comprise	comprising
elevate	elevating
indulge	indulging
cane	caning
attract	attracting
heave	heaving
pester	pestering
command	commanding
clothe	clothing
mimic	mimicking
retell	retelling
complain	complaining
die	dying
hiss	hissing
manifest	manifesting
stray	straying
weld	welding
repeat	repeating
dive	diving
redevelop	redeveloping
float	floating
fast	fasting
hammer	hammering
signal	signaling
lighten	lightening
jail	jailing
don	donning
board	boarding
vacate	vacating
promulgate	promulgating
amaze	amazing
speak	speaking
gear	gearing
stump	stumping
prosper	prospering
envision	envisioning
abduct	abducting
spot	spotting
shoot	shooting
own	owning
explore	exploring
imply	implying
disappear	disappearing
captain	captaining
congregate	congregating
scratch	scratching
codify	codifying
mourn	mourning
scrap	scraping
mill	milling
tot	toting
rehearse	rehearsing
persecute	persecuting
wrap	wrapping
course	coursing
supply	supplying
daydream	daydreaming
quell	quelling
blast	blasting
raise	raising
breach	breaching
educate	educating
insist	insisting
quiz	quizzing
be	being
scale	scaling
reel	reeling
steam	steaming
dress	dressing
fit	fitting
assure	assuring
bulge	bulging
shore	shoring
hock	hocking
plummet	plummeting
bombard	bombarding
enclose	enclosing
pop	popping
stop	stopping
criticize	criticizing
down	downing
roar	roaring
joke	joking
gun	gunning
underpin	underpinning
mop	mopping
harmonize	harmonizing
snip	sniping
brighten	brightening
foot	footing
withhold	withholding
winter	wintering
follow	following
toast	toasting
yellow	yellowing
smooth	smoothing
troll	trolling
finance	financing
advise	advising
reign	reigning
cross	crossing
complete	completing
resell	reselling
succeed	succeeding
differ	differing
track	tracking
attach	attaching
offend	offending
abolish	abolishing
compromise	compromising
flout	flouting
rig	rigging
woo	wooing
lace	lacing
climb	climbing
boost	boosting
control	controlling
click	clicking
deplore	deploring
intermingle	intermingling
lounge	lounging
drink	drinking
overshadow	overshadowing
rate	rating
party	partying
dream	dreaming
rejoin	rejoining
do	doing
crackle	crackling
stock	stocking
fray	fraying
subscribe	subscribing
blend	blending
befriend	befriending
duplicate	duplicating
coin	coining
skew	skewing
go	going
fault	faulting
broker	brokering
knock	knocking
peddle	peddling
sneeze	sneezing
engage	engaging
off	offing
recycle	recycling
exact	exacting
faint	fainting
suffer	suffering
conform	conforming
harm	harming
threaten	threatening
revise	revising
guess	guessing
tune	tuning
beep	beeping
confine	confining
disapprove	disapproving
strike	striking
dribble	dribbling
elaborate	elaborating
specify	specifying
channel	channeling
scare	scaring
jeopardize	jeopardizing
revisit	revisiting
derail	derailing
branch	branching
smile	smiling
usurp	usurping
agitate	agitating
fade	fading
restore	restoring
exclude	excluding
bar	barring
alternate	alternating
enlarge	enlarging
cram	cramming
supplant	supplanting
starve	starving
flirt	flirting
swing	swinging
beef	beefing
upload	uploading
hug	hugging
handle	handling
rhyme	rhyming
proselytize	proselytizing
demand	demanding
bash	bashing
master	mastering
sell	selling
sparkle	sparkling
purge	purging
chew	chewing
kiss	kissing
stir	stirring
hold	holding
litter	littering
conceive	conceiving
omit	omitting
breathe	breathing
default	defaulting
decompose	decomposing
lie	lying
suppose	supposing
pass	passing
illustrate	illustrating
misread	misreading
rocket	rocketing
exert	exerting
lurk	lurking
poach	poaching
appropriate	appropriating
visit	visiting
supervise	supervising
fumble	fumbling
smack	smacking
implicate	implicating
feast	feasting
declare	declaring
size	sizing
dub	dubbing
seek	seeking
compound	compounding
correct	correcting
inherit	inheriting
cull	culling
bite	biting
console	consoling
haggle	haggling
punish	punishing
hover	hovering
designate	designating
smash	smashing
numb	numbing
outstrip	outstripping
process	processing
recoup	recouping
integrate	integrating
entertain	entertaining
traffic	trafficking
tick	ticking
shiver	shivering
pinpoint	pinpointing
color	coloring
garden	gardening
cut	cutting
disintegrate	disintegrating
announce	announcing
crank	cranking
construct	constructing
split	splitting
set	setting
dispense	dispensing
meet	meeting
overspend	overspending
peek	peeking
boo	booing
sweep	sweeping
coexist	coexisting
undermine	undermining
nourish	nourishing
compute	computing
lag	lagging
fear	fearing
appraise	appraising
rent	renting
overthrow	overthrowing
lynch	lynching
masquerade	masquerading
mob	mobbing
tailor	tailoring
hang	hanging
court	courting
remain	remaining
squeal	squealing
run	running
need	needing
stem	stemming
arch	arching
squat	squatting
fry	frying
stalk	stalking
contrast	contrasting
broadcast	broadcasting
budget	budgeting
crouch	crouching
hark	harking
let	letting
innovate	innovating
delete	deleting
count	counting
wait	waiting
shave	shaving
digest	digesting
head	heading
gaze	gazing
drift	drifting
dam	damming
parallel	paralleling
deport	deporting
snub	snubbing
price	pricing
paper	papering
stride	striding
corner	cornering
dilute	diluting
ask	asking
unveil	unveiling
transcend	transcending
string	stringing
call	calling
praise	praising
jam	jamming
repel	repelling
putt	putting
dare	daring
beg	begging
greet	greeting
back	backing
balk	balking
astonish	astonishing
network	networking
shear	shearing
destroy	destroying
synthesize	synthesizing
slant	slanting
penetrate	penetrating
whittle	whittling
prefer	preferring
term	terming
revolutionize	revolutionizing
kid	kidding
rescue	rescuing
misuse	misusing
shuffle	shuffling
disallow	disallowing
evade	evading
stereotype	stereotyping
maneuver	maneuvering
peg	pegging
douse	dousing
speculate	speculating
denounce	denouncing
endear	endearing
index	indexing
form	forming
abide	abiding
depose	deposing
convene	convening
room	rooming
fuse	fusing
assert	asserting
adhere	adhering
tip	tipping
fold	folding
steal	stealing
imprint	imprinting
hike	hiking
notice	noticing
return	returning
pedal	pedaling
uphold	upholding
rave	raving
harass	harassing
behead	beheading
strengthen	strengthening
scream	screaming
smoke	smoking
sling	slinging
escalate	escalating
congratulate	congratulating
favor	favoring
shape	shaping
subdue	subduing
parade	parading
emanate	emanating
terrorize	terrorizing
bound	bounding
decimate	decimating
flock	flocking
read	reading
soar	soaring
bustle	bustling
critique	critiquing
rope	roping
rev	revving
commercialize	commercializing
gore	goring
conclude	concluding
testify	testifying
shrink	shrinking
tingle	tingling
aim	aiming
pair	pairing
hijack	hijacking
glitter	glittering
ramp	ramping
poll	polling
wag	wagging
equate	equating
reprint	reprinting
dissolve	dissolving
loop	looping
falter	faltering
pause	pausing
discover	discovering
quash	quashing
talk	talking
suck	sucking
spit	spitting
line	lining
tweak	tweaking
contest	contesting
shatter	shattering
chart	charting
deliver	delivering
pot	potting
light	lighting
punt	punting
pelt	pelting
prioritize	prioritizing
capture	capturing
bail	bailing
hurry	hurrying
heap	heaping
gamble	gambling
ascend	ascending
forage	foraging
pretend	pretending
leaven	leavening
stick	sticking
tame	taming
accede	acceding
subsidize	subsidizing
swim	swimming
spiral	spiralling
shy	shying
energize	energizing
frank	franking
pet	petting
twine	twining
tell	telling
fertilize	fertilizing
sear	searing
wreak	wreaking
inflate	inflating
search	searching
contribute	contributing
swarm	swarming
decode	decoding
imprison	imprisoning
antagonize	antagonizing
grudge	grudging
roam	roaming
widen	widening
surround	surrounding
disband	disbanding
glance	glancing
fudge	fudging
divest	divesting
administer	administering
open	opening
ebb	ebbing
butt	butting
afflict	afflicting
live	living
torch	torching
moonlight	moonlighting
delegate	delegating
fracture	fracturing
mine	mining
underwrite	underwriting
mouth	mouthing
flash	flashing
revolve	revolving
research	researching
interrupt	interrupting
insulate	insulating
mainstream	mainstreaming
caution	cautioning
long	longing
print	printing
rumble	rumbling
shout	shouting
compel	compelling
overturn	overturning
capitalize	capitalizing
fence	fencing
endanger	endangering
recommend	recommending
whisper	whispering
trace	tracing
profit	profiting
concentrate	concentrating
receive	receiving
rant	ranting
photograph	photographing
dig	digging
trek	trekking
pine	pining
coerce	coercing
bootleg	bootlegging
broaden	broadening
rush	rushing
transmit	transmitting
cart	carting
dance	dancing
ward	warding
taper	tapering
win	winning
tremble	trembling
hem	hemming
ratchet	ratcheting
videotape	videotaping
hurl	hurling
discontinue	discontinuing
like	liking
picket	picketing
spill	spilling
bait	baiting
embark	embarking
tempt	tempting
improve	improving
referee	refereeing
unearth	unearthing
dwell	dwelling
design	designing
smear	smearing
invite	inviting
flail	flailing
resent	resenting
brew	brewing
privatize	privatizing
excavate	excavating
dot	doting
benefit	benefiting
outlaw	outlawing
originate	originating
conspire	conspiring
home	homing
outperform	outperforming
pin	pinning
lower	lowering
startle	startling
slop	sloping
attain	attaining
fuck	fucking
demonstrate	demonstrating
target	targeting
bark	barking
orbit	orbiting
contradict	contradicting
tolerate	tolerating
rid	riding
consign	consigning
imitate	imitating
taste	tasting
itch	itching
scan	scanning
accelerate	accelerating
shin	shining
massage	massaging
infringe	infringing
sprinkle	sprinkling
drum	drumming
limit	limiting
brave	braving
gust	gusting
mess	messing
graduate	graduating
bother	bothering
park	parking
contract	contracting
impound	impounding
croak	croaking
motor	motoring
reschedule	rescheduling
idle	idling
unify	unifying
bare	baring
disclose	disclosing
retrofit	retrofitting
wash	washing
bed	bedding
duel	dueling
heat	heating
discipline	disciplining
discourage	discouraging
thrash	thrashing
appear	appearing
activate	activating
lift	lifting
trash	trashing
encroach	encroaching
validate	validating
lurch	lurching
clap	clapping
chill	chilling
mug	mugging
sound	sounding
document	documenting
intern	interning
crusade	crusading
labor	laboring
blockade	blockading
ravage	ravaging
bumble	bumbling
berate	berating
landscape	landscaping
belong	belonging
intervene	intervening
crush	crushing
collide	colliding
consider	considering
zoom	zooming
brown	browning
disable	disabling
outweigh	outweighing
coax	coaxing
overpay	overpaying
tilt	tilting
defer	deferring
retain	retaining
etch	etching
retrain	retraining
impart	imparting
wreck	wrecking
turn	turning
restructure	restructuring
market	marketing
reduce	reducing
share	sharing
wax	waxing
muster	mustering
can	canning
concede	conceding
loan	loaning
suppress	suppressing
step	stepping
spark	sparking
combine	combining
fan	fanning
rekindle	rekindling
vote	voting
gesture	gesturing
decipher	deciphering
rely	relying
know	knowing
forsake	forsaking
hop	hoping
circulate	circulating
influence	influencing
institute	instituting
rewrite	rewriting
harden	hardening
lease	leasing
subvert	subverting
wade	wading
gouge	gouging
auction	auctioning
defuse	defusing
cramp	cramping
screech	screeching
blackmail	blackmailing
symbolize	symbolizing
intrude	intruding
dose	dosing
finish	finishing
blame	blaming
label	labeling
invalidate	invalidating
abound	abounding
smart	smarting
crave	craving
rang	ranging
franchise	franchising
imagine	imagining
fine	fining
crumble	crumbling
digitize	digitizing
replicate	replicating
tax	taxing
rectify	rectifying
bottle	bottling
meddle	meddling
trumpet	trumpeting
incorporate	incorporating
twinkle	twinkling
appease	appeasing
disprove	disproving
encourage	encouraging
swallow	swallowing
scout	scouting
slave	slaving
craft	crafting
machine	machining
profile	profiling
repress	repressing
tire	tiring
meditate	meditating
segregate	segregating
punch	punching
shimmer	shimmering
cripple	crippling
walk	walking
picnic	picnicking
hasten	hastening
square	squaring
reach	reaching
misunderstand	misunderstanding
enact	enacting
code	coding
officiate	officiating
assassinate	assassinating
scoop	scooping
enrich	enriching
yawn	yawning
prepare	preparing
tackle	tackling
confound	confounding
squeak	squeaking
assign	assigning
masturbate	masturbating
characterize	characterizing
pluck	plucking
charter	chartering
arouse	arousing
approach	approaching
comply	complying
sharpen	sharpening
state	stating
firm	firming
analyze	analyzing
clamp	clamping
slump	slumping
salute	saluting
calm	calming
slim	slimming
facilitate	facilitating
nurse	nursing
photocopy	photocopying
rally	rallying
solicit	soliciting
gleam	gleaming
wheel	wheeling
bunch	bunching
guard	guarding
stretch	stretching
ooze	oozing
pitch	pitching
purport	purporting
cheat	cheating
grip	gripping
wound	wounding
cheer	cheering
regret	regretting
derive	deriving
memorize	memorizing
watch	watching
refund	refunding
pit	pitting
correlate	correlating
dominate	dominating
popularize	popularizing
motivate	motivating
restart	restarting
render	rendering
indicate	indicating
proliferate	proliferating
refuse	refusing
blow	blowing
oppose	opposing
land	landing
date	dating
have	having
miss	missing
contact	contacting
ship	shipping
contend	contending
downplay	downplaying
sum	summing
degenerate	degenerating
bristle	bristling
surface	surfacing
help	helping
sustain	sustaining
neutralize	neutralizing
sour	souring
cock	cocking
tumble	tumbling
renovate	renovating
modernize	modernizing
inspire	inspiring
remodel	remodeling
foil	foiling
falsify	falsifying
emigrate	emigrating
address	addressing
position	positioning
extort	extorting
throb	throbbing
encircle	encircling
tidy	tidying
deter	deterring
crowd	crowding
spur	spurring
phase	phasing
strive	striving
brag	bragging
bless	blessing
relish	relishing
spin	spinning
out	outing
bicker	bickering
displace	displacing
try	trying
serve	serving
replenish	replenishing
voice	voicing
thwart	thwarting
shut	shutting
mirror	mirroring
register	registering
unravel	unraveling
value	valuing
rouse	rousing
spook	spooking
interlock	interlocking
attribute	attributing
stifle	stifling
flare	flaring
repair	repairing
multiply	multiplying
distinguish	distinguishing
bathe	bathing
barter	bartering
flag	flagging
utter	uttering
yell	yelling
populate	populating
straighten	straightening
hound	hounding
scavenge	scavenging
sew	sewing
kneel	kneeling
farm	farming
tease	teasing
sing	singing
estimate	estimating
perform	performing
participate	participating
piece	piecing
travel	traveling
spout	spouting
dumb	dumbing
trespass	trespassing
tag	tagging
jog	jogging
filibuster	filibustering
wink	winking
pare	paring
rescind	rescinding
wish	wishing
boot	booting
build	building
sizzle	sizzling
equalize	equalizing
enslave	enslaving
create	creating
relinquish	relinquishing
purify	purifying
supersede	superseding
zigzag	zigzagging
choose	choosing
bolster	bolstering
deposit	depositing
detect	detecting
ramble	rambling
redirect	redirecting
endorse	endorsing
breed	breeding
witness	witnessing
package	packaging
encode	encoding
visualize	visualizing
march	marching
negotiate	negotiating
impact	impacting
ride	riding
dispose	disposing
task	tasking
dog	dogging
extend	extending
mention	mentioning
counter	countering
mumble	mumbling
howl	howling
maim	maiming
retool	retooling
stage	staging
hack	hacking
torment	tormenting
recede	receding
bend	bending
reside	residing
rethink	rethinking
inaugurate	inaugurating
prune	pruning
queue	queuing
intend	intending
gain	gaining
wither	withering
bill	billing
revitalize	revitalizing
weigh	weighing
degrade	degrading
defeat	defeating
staff	staffing
formulate	formulating
traverse	traversing
peer	peering
cough	coughing
exterminate	exterminating
solve	solving
justify	justifying
dispute	disputing
wipe	wiping
forward	forwarding
press	pressing
procure	procuring
double	doubling
star	starring
halve	halving
plaster	plastering
wilt	wilting
compost	composting
contemplate	contemplating
dash	dashing
gross	grossing
protrude	protruding
buy	buying
feed	feeding
paste	pasting
base	basing
squeeze	squeezing
refrain	refraining
stay	staying
affect	affecting
pace	pacing
come	coming
bottom	bottoming
revert	reverting
stitch	stitching
swamp	swamping
grapple	grappling
overhaul	overhauling
rebel	rebelling
renege	reneging
copy	copying
diminish	diminishing
equal	equalling
reuse	reusing
argue	arguing
link	linking
strain	straining
improvise	improvising
angle	angling
reap	reaping
flood	flooding
refuel	refueling
ignite	igniting
retake	retaking
waste	wasting
vacation	vacationing
enable	enabling
stake	staking
rinse	rinsing
bar	baring
extradite	extraditing
awaken	awakening
compare	comparing
admit	admitting
cloud	clouding
acquire	acquiring
pervade	pervading
groom	grooming
plant	planting
cost	costing
cede	ceding
terminate	terminating
tout	touting
surrender	surrendering
pollute	polluting
deploy	deploying
brainwash	brainwashing
comment	commenting
exploit	exploiting
renounce	renouncing
rib	ribbing
work	working
undo	undoing
foretell	foretelling
minimize	minimizing
dry	drying
orchestrate	orchestrating
pioneer	pioneering
regroup	regrouping
reclaim	reclaiming
clutch	clutching
bolt	bolting
page	paging
dangle	dangling
swell	swelling
scour	scouring
patrol	patrolling
attempt	attempting
manage	managing
burst	bursting
rag	raging
scurry	scurrying
rearm	rearming
scalp	scalping
swap	swapping
doubt	doubting
unlock	unlocking
impersonate	impersonating
enlighten	enlightening
kindle	kindling
burrow	burrowing
interact	interacting
rest	resting
upset	upsetting
theorize	theorizing
riot	rioting
beat	beating
persist	persisting
dine	dining
accept	accepting
grin	grinning
counsel	counselling
deride	deriding
conceal	concealing
bridge	bridging
skirt	skirting
articulate	articulating
row	rowing
blanket	blanketing
salt	salting
stagnate	stagnating
decorate	decorating
gasp	gasping
devalue	devaluing
ordain	ordaining
cap	capping
baffle	baffling
impose	imposing
reprise	reprising
buck	bucking
torture	torturing
review	reviewing
simplify	simplifying
shield	shielding
harness	harnessing
react	reacting
pour	pouring
cleanse	cleansing
conjure	conjuring
picture	picturing
evict	evicting
tend	tending
ponder	pondering
rehabilitate	rehabilitating
cite	citing
bankrupt	bankrupting
stockpile	stockpiling
shadow	shadowing
adjourn	adjourning
smother	smothering
rail	railing
scuttle	scuttling
become	becoming
audit	auditing
bike	biking
bet	betting
reason	reasoning
disturb	disturbing
carry	carrying
rupture	rupturing
bind	binding
bud	budding
hail	hailing
flick	flicking
fare	faring
audition	auditioning
mull	mulling
rot	rotting
hinge	hinging
await	awaiting
suspect	suspecting
clip	clipping
near	nearing
associate	associating
connect	connecting
expire	expiring
stonewall	stonewalling
subcontract	subcontracting
navigate	navigating
freeze	freezing
develop	developing
scramble	scrambling
foster	fostering
uplift	uplifting
prevent	preventing
weed	weeding
recite	reciting
interrogate	interrogating
dunk	dunking
relocate	relocating
schedule	scheduling
ransack	ransacking
christen	christening
tickle	tickling
ice	icing
buffet	buffeting
infiltrate	infiltrating
resort	resorting
single	singling
splinter	splintering
strip	stripping
scar	scaring
emerge	emerging
survey	surveying
vibrate	vibrating
rival	rivaling
involve	involving
approve	approving
function	functioning
distract	distracting
hash	hashing
distress	distressing
remark	remarking
roll	rolling
accompany	accompanying
reassess	reassessing
terrify	terrifying
assimilate	assimilating
organize	organizing
act	acting
move	moving
nod	nodding
teach	teaching
troop	trooping
corrupt	corrupting
poison	poisoning
inflict	inflicting
televise	televising
sample	sampling
banish	banishing
devolve	devolving
welcome	welcoming
bypass	bypassing
mislead	misleading
bump	bumping
strap	strapping
repay	repaying
bubble	bubbling
risk	risking
ease	easing
charm	charming
dispatch	dispatching
flex	flexing
loaf	loafing
export	exporting
sift	sifting
deprive	depriving
hunt	hunting
constrain	constraining
decommission	decommissioning
understate	understating
taxi	taxiing
start	starting
repudiate	repudiating
poke	poking
object	objecting
slit	slitting
browse	browsing
compress	compressing
insert	inserting
operate	operating
deceive	deceiving
interest	interesting
mask	masking
surpass	surpassing
obscure	obscuring
distort	distorting
preside	presiding
milk	milking
seal	sealing
legitimize	legitimizing
film	filming
embellish	embellishing
thread	threading
continue	continuing
predict	predicting
purchase	purchasing
leverage	leveraging
reaffirm	reaffirming
offer	offering
criminalize	criminalizing
escort	escorting
inflame	inflaming
sail	sailing
backtrack	backtracking
splice	splicing
station	stationing
care	caring
reverse	reversing
consolidate	consolidating
herd	herding
power	powering
repatriate	repatriating
join	joining
sacrifice	sacrificing
refine	refining
sob	sobbing
underline	underlining
average	averaging
interview	interviewing
dwarf	dwarfing
drain	draining
ache	aching
forge	forging
convey	conveying
ferry	ferrying
belch	belching
focus	focusing
blind	blinding
resonate	resonating
pledge	pledging
clean	cleaning
crunch	crunching
wager	wagering
arise	arising
oblige	obliging
toss	tossing
download	downloading
defecate	defecating
bleach	bleaching
coat	coating
wail	wailing
ballot	balloting
conflict	conflicting
inform	informing
mean	meaning
veer	veering
morph	morphing
fabricate	fabricating
trail	trailing
secede	seceding
remake	remaking
splash	splashing
understand	understanding
letter	lettering
raid	raiding
flaunt	flaunting
add	adding
grill	grilling
hurdle	hurdling
excel	excelling
endure	enduring
blister	blistering
err	erring
hear	hearing
weight	weighting
maintain	maintaining
disguise	disguising
refurbish	refurbishing
hate	hating
invigorate	invigorating
propel	propelling
support	supporting
delve	delving
pronounce	pronouncing
slaughter	slaughtering
lose	losing
concern	concerning
blot	blotting
hint	hinting
disgust	disgusting
damp	damping
paddle	paddling
flourish	flourishing
plow	plowing
rape	raping
forfeit	forfeiting
experiment	experimenting
expel	expelling
spare	sparing
dope	doping
con	conning
merchandise	merchandising
foam	foaming
orient	orienting
renew	renewing
elect	electing
colonize	colonizing
opt	opting
hedge	hedging
question	questioning
wonder	wondering
overestimate	overestimating
resist	resisting
ski	skiing
extract	extracting
fix	fixing
rebuild	rebuilding
aggravate	aggravating
dodge	dodging
screw	screwing
attest	attesting
intensify	intensifying
hamper	hampering
behave	behaving
field	fielding
besiege	besieging
huddle	huddling
transfer	transferring
galvanize	galvanizing
arrive	arriving
spew	spewing
evaluate	evaluating
rat	rating
believe	believing
teleconference	teleconferencing
expose	exposing
glare	glaring
embed	embedding
publish	publishing
butcher	butchering
shop	shopping
layer	layering
rack	racking
eject	ejecting
flatter	flattering
promote	promoting
inquire	inquiring
wean	weaning
divide	dividing
display	displaying
conduct	conducting
sneak	sneaking
chatter	chattering
skip	skipping
tailgate	tailgating
shepherd	shepherding
narrate	narrating
triumph	triumphing
overhang	overhanging
allege	alleging
learn	learning
bundle	bundling
repeal	repealing
scope	scoping
whine	whining
restrict	restricting
sow	sowing
reorganize	reorganizing
cope	coping
match	matching
drape	draping
topple	toppling
commemorate	commemorating
bond	bonding
patronize	patronizing
season	seasoning
spiral	spiraling
apply	applying
sentence	sentencing
age	aging
giggle	giggling
incite	inciting
coach	coaching
top	topping
quantify	quantifying
honk	honking
transport	transporting
reassert	reasserting
satisfy	satisfying
adopt	adopting
wring	wringing
funnel	funneling
apprehend	apprehending
empower	empowering
bath	bathing
ascribe	ascribing
answer	answering
lock	locking
bag	bagging
grind	grinding
rip	ripping
investigate	investigating
fund	funding
plate	plating
commend	commending
bid	biding
range	ranging
hop	hopping
phone	phoning
panic	panicking
compete	competing
haul	hauling
inch	inching
immigrate	immigrating
shine	shining
clog	clogging
roost	roosting
loosen	loosening
seduce	seducing
belt	belting
trade	trading
regulate	regulating
blunt	blunting
feather	feathering
alter	altering
fashion	fashioning
disregard	disregarding
thrill	thrilling
thicken	thickening
tan	tanning
accord	according
negate	negating
pound	pounding
rejuvenate	rejuvenating
arrange	arranging
write	writing
sanction	sanctioning
afford	affording
abuse	abusing
crash	crashing
pursue	pursuing
trickle	trickling
bang	banging
plan	planing
sway	swaying
espouse	espousing
slug	slugging
pipe	piping
cement	cementing
recover	recovering
extol	extolling
pinch	pinching
refill	refilling
blank	blanking
urge	urging
refer	referring
bribe	bribing
formalize	formalizing
verge	verging
snarl	snarling
disperse	dispersing
amplify	amplifying
firebomb	firebombing
take	taking
sweat	sweating
prompt	prompting
warp	warping
mesh	meshing
twitch	twitching
survive	surviving
squander	squandering
govern	governing
spar	sparring
fork	forking
yodel	yodeling
hire	hiring
reintroduce	reintroducing
hit	hitting
alleviate	alleviating
author	authoring
invest	investing
precede	preceding
jack	jacking
scar	scarring
stun	stunning
scheme	scheming
gut	gutting
confront	confronting
cling	clinging
ham	hamming
span	spanning
conserve	conserving
throw	throwing
downsize	downsizing
deflect	deflecting
ensue	ensuing
stink	stinking
pray	praying
study	studying
disarm	disarming
brood	brooding
major	majoring
rock	rocking
disseminate	disseminating
rid	ridding
peck	pecking
perpetuate	perpetuating
quadruple	quadrupling
result	resulting
fester	festering
plane	planing
bug	bugging
lend	lending
deplete	depleting
certify	certifying
switch	switching
teeter	teetering
categorize	categorizing
catch	catching
gape	gaping
discredit	discrediting
weather	weathering
delight	delighting
scrub	scrubbing
rake	raking
disparage	disparaging
anticipate	anticipating
slay	slaying
inhale	inhaling
empty	emptying
excite	exciting
select	selecting
prolong	prolonging
glow	glowing
anchor	anchoring
clash	clashing
bat	batting
confuse	confusing
marry	marrying
collaborate	collaborating
occur	occurring
portray	portraying
donate	donating
cover	covering
radiate	radiating
score	scoring
collapse	collapsing
wrestle	wrestling
linger	lingering
reimburse	reimbursing
blaze	blazing
credit	crediting
enhance	enhancing
ready	readying
bruise	bruising
upgrade	upgrading
belittle	belittling
remove	removing
plague	plaguing
outpace	outpacing
undertake	undertaking
white	whiting
pay	paying
liken	likening
partner	partnering
rotate	rotating
fasten	fastening
stabilize	stabilizing
overlook	overlooking
key	keying
thaw	thawing
nationalize	nationalizing
shuttle	shuttling
flutter	fluttering
enter	entering
claim	claiming
fret	fretting
deliberate	deliberating
intrigue	intriguing
dampen	dampening
drip	dripping
loom	looming
urinate	urinating
finalize	finalizing
sidestep	sidestepping
delay	delaying
employ	employing
coincide	coinciding
outline	outlining
reiterate	reiterating
collect	collecting
send	sending
include	including
decry	decrying
drill	drilling
surge	surging
sculpt	sculpting
modify	modifying
subject	subjecting
paint	painting
dictate	dictating
spoil	spoiling
interface	interfacing
uncover	uncovering
hog	hogging
grieve	grieving
enlist	enlisting
comprehend	comprehending
think	thinking
emit	emitting
revolt	revolting
equip	equipping
overcome	overcoming
oil	oiling
surf	surfing
batter	battering
vault	vaulting
wander	wandering
cave	caving
stare	staring
discriminate	discriminating
vet	vetting
reinvest	reinvesting
clarify	clarifying
calculate	calculating
stroke	stroking
check	checking
patent	patenting
preserve	preserving
source	sourcing
feud	feuding
ditch	ditching
prevail	prevailing
up	upping
quit	quitting
implement	implementing
tear	tearing
snoop	snooping
highlight	highlighting
insure	insuring
pillage	pillaging
subside	subsiding
crest	cresting
plunder	plundering
absorb	absorbing
ply	plying
tube	tubing
soldier	soldiering
rob	robbing
permit	permitting
barricade	barricading
weep	weeping
toil	toiling
haunt	haunting
slumber	slumbering
pulse	pulsing
disqualify	disqualifying
spank	spanking
laugh	laughing
implore	imploring
time	timing
applaud	applauding
judge	judging
exacerbate	exacerbating
incur	incurring
roof	roofing
pack	packing
accumulate	accumulating
shake	shaking
generalize	generalizing
distance	distancing
massacre	massacring
embody	embodying
bluff	bluffing
mete	meting
pole	poling
record	recording
sign	signing
depress	depressing
sober	sobering
haze	hazing
unfold	unfolding
rearrange	rearranging
tone	toning
jettison	jettisoning
sort	sorting
guide	guiding
be	bing
pull	pulling
decline	declining
flank	flanking
waive	waiving
speed	speeding
barge	barging
foul	fouling
scent	scenting
bid	bidding
quote	quoting
outfit	outfitting
whiten	whitening
refute	refuting
stab	stabbing
edge	edging
boast	boasting
twin	twining
fill	filling
anger	angering
eavesdrop	eavesdropping
reinstate	reinstating
tally	tallying
iron	ironing
streak	streaking
scold	scolding
wrangle	wrangling
lecture	lecturing
fight	fighting
snowball	snowballing
discuss	discussing
till	tilling
bleed	bleeding
moan	moaning
thank	thanking
levy	levying
proceed	proceeding
withdraw	withdrawing
sense	sensing
perceive	perceiving
oppress	oppressing
classify	classifying
patch	patching
group	grouping
introduce	introducing
abate	abating
free	freeing
fetch	fetching
stoke	stoking
fend	fending
streamline	streamlining
bus	busing
overhear	overhearing
outnumber	outnumbering
encounter	encountering
weave	weaving
execute	executing
budge	budging
house	housing
recapture	recapturing
illuminate	illuminating
debunk	debunking
mind	minding
sprint	sprinting
hitch	hitching
root	rooting
inspect	inspecting
require	requiring
pierce	piercing
annex	annexing
rout	routing
slide	sliding
adjust	adjusting
respond	responding
graze	grazing
joust	jousting
reject	rejecting
adorn	adorning
simulate	simulating
sympathize	sympathizing
void	voiding
darken	darkening
glean	gleaning
entrust	entrusting
insult	insulting
reunite	reuniting
evacuate	evacuating
boom	booming
anoint	anointing
blossom	blossoming
elicit	eliciting
scroll	scrolling
vomit	vomiting
curl	curling
thrust	thrusting
bowl	bowling
hand	handing
volunteer	volunteering
word	wording
crack	cracking
challenge	challenging
legalize	legalizing
name	naming
dissect	dissecting
muscle	muscling
discard	discarding
redistribute	redistributing
overtake	overtaking
bob	bobbing
siphon	siphoning
devote	devoting
glorify	glorifying
eclipse	eclipsing
vary	varying
skyrocket	skyrocketing
blur	blurring
heckle	heckling
publicize	publicizing
depend	depending
intercept	intercepting
burden	burdening
sack	sacking
abandon	abandoning
loose	loosing
peter	petering
journey	journeying
flow	flowing
evaporate	evaporating
bury	burying
dismantle	dismantling
reload	reloading
wet	wetting
lean	leaning
fling	flinging
assess	assessing
fail	failing
sand	sanding
green	greening
decay	decaying
shelve	shelving
squabble	squabbling
oust	ousting
legislate	legislating
even	evening
trot	trotting
sting	stinging
stroll	strolling
tramp	tramping
exchange	exchanging
tote	toting
alert	alerting
assist	assisting
exhaust	exhausting
moor	mooring
rank	ranking
find	finding
see	seeing
flush	flushing
inject	injecting
ban	banning
hoard	hoarding
wane	waning
cluster	clustering
shriek	shrieking
invoke	invoking
customize	customizing
rationalize	rationalizing
correspond	corresponding
blush	blushing
clear	clearing
appoint	appointing
bunt	bunting
plead	pleading
bring	bringing
pore	poring
make	making
cater	catering
flap	flapping
regenerate	regenerating
laud	lauding
defend	defending
confess	confessing
spread	spreading
cycle	cycling
recuperate	recuperating
type	typing
except	excepting
man	manning
swoop	swooping
garner	garnering
duck	ducking
sever	severing
spend	spending
toughen	toughening
proclaim	proclaiming
infect	infecting
slice	slicing
latch	latching
wallow	wallowing
fiddle	fiddling
ring	ringing
revive	reviving
quarrel	quarreling
clown	clowning
bias	biasing
grace	gracing
reform	reforming
rust	rusting
style	styling
progress	progressing
wrench	wrenching
band	banding
confer	conferring
prosecute	prosecuting
tabulate	tabulating
advance	advancing
cancel	canceling
underscore	underscoring
rend	rending
rivet	riveting
stream	streaming
peel	peeling
say	saying
dim	dimming
gather	gathering
remind	reminding
wine	wining
notify	notifying
devise	devising
creep	creeping
protect	protecting
look	looking
twist	twisting
shrug	shrugging
verify	verifying
deregulate	deregulating
moderate	moderating
envelop	enveloping
ticket	ticketing
space	spacing
flicker	flickering
