essay	essays
patent	patents
lawmaker	lawmakers
wine	wines
camp	camps
pair	pairs
dwelling	dwellings
circle	circles
stray	strays
soviet	soviets
mythology	mythologies
raise	raises
beating	beatings
engineer	engineers
backer	backers
manual	manuals
over	overs
defect	defects
fatality	fatalities
jury	juries
grasshopper	grasshoppers
pic	pics
misery	miseries
pitcher	pitchers
hit	hits
mission	missions
kiwi	kiwis
muzzle	muzzles
sprint	sprints
tactic	tactics
diagnosis	diagnoses
yolk	yolks
captain	captains
fit	fits
seer	seers
theme	themes
depression	depressions
sediment	sediments
sort	sorts
script	scripts
launch	launches
lot	lots
onion	onions
coffin	coffins
winter	winters
sprout	sprouts
carb	carbs
dioxin	dioxins
location	locations
flirt	flirts
route	routes
transcript	transcripts
debtor	debtors
mobile	mobiles
hub	hubs
serving	servings
button	buttons
aisle	aisles
cup	cups
organizer	organizers
senior	seniors
warranty	warranties
shackle	shackles
courtyard	courtyards
fig	figs
phosphate	phosphates
kill	kills
cell	cells
rupture	ruptures
debutante	debutantes
beast	beasts
salesperson	salespeople
ulcer	ulcers
sin	sins
brush	brushes
larva	larvae
chromosome	chromosomes
tendon	tendons
luncheon	luncheons
sigh	sighs
peso	pesos
banner	banners
incursion	incursions
fabric	fabrics
cat	cats
puffin	puffins
jug	jugs
placard	placards
client	clients
novice	novices
hip	hips
victor	victors
shilling	shillings
bet	bets
caterpillar	caterpillars
rein	reins
python	pythons
psychopath	psychopaths
costume	costumes
democrat	democrats
hemisphere	hemispheres
middleman	middlemen
ensemble	ensembles
herald	heralds
sander	sanders
hawk	hawks
springbok	springboks
situation	situations
thoroughfare	thoroughfares
parenthesis	parentheses
setter	setters
guerrilla	guerrillas
key	keys
break	breaks
terminal	terminals
entry	entries
bellow	bellows
airstrip	airstrips
pilot	pilots
length	lengths
kiss	kisses
ladder	ladders
cutter	cutters
subdivision	subdivisions
reformer	reformers
sword	swords
user	users
duet	duets
child	children
axis	axes
trucker	truckers
lounge	lounges
minor	minors
kidney	kidneys
almond	almonds
baton	batons
factory	factories
businessman	businessmen
currency	currencies
plantation	plantations
institute	institutes
stoppage	stoppages
navy	navies
million	millions
provider	providers
corporal	corporals
seasoning	seasonings
wheel	wheels
transmitter	transmitters
tow	tows
wolf	wolves
lamp	lamps
expense	expenses
bust	busts
grid	grids
prediction	predictions
gum	gums
darling	darlings
apple	apples
fed	feds
outline	outlines
scoundrel	scoundrels
trooper	troopers
trio	trios
shoemaker	shoemakers
nozzle	nozzles
parrot	parrots
river	rivers
canal	canals
sortie	sorties
payoff	payoffs
spacesuit	spacesuits
positive	positives
cooperative	cooperatives
allusion	allusions
differential	differentials
kingdom	kingdoms
asteroid	asteroids
voice	voices
strategy	strategies
sponsorship	sponsorships
saloon	saloons
stranger	strangers
plum	plums
cooler	coolers
clue	clues
smith	smiths
badger	badgers
gnat	gnats
charity	charities
finger	fingers
picker	pickers
demo	demos
cyst	cysts
freeman	freemen
given	givens
escapee	escapees
batter	batters
parody	parodies
headset	headsets
nerd	nerds
linkage	linkages
excerpt	excerpts
greeting	greetings
digit	digits
quantity	quantities
interstate	interstates
franchisee	franchisees
flip	flips
vault	vaults
survey	surveys
prodigy	prodigies
flaw	flaws
shrink	shrinks
slugger	sluggers
suspect	suspects
breakthrough	breakthroughs
handle	handles
custom	customs
rag	rages
tapestry	tapestries
cruelty	cruelties
donor	donors
trigger	triggers
tom	toms
duck	ducks
memento	mementos
capitalist	capitalists
slur	slurs
bouquet	bouquets
punt	punts
latrine	latrines
retake	retakes
lookout	lookouts
omen	omens
legion	legions
handgun	handguns
one	ones
fad	fads
bargain	bargains
comedian	comedians
circumstance	circumstances
rug	rugs
snowstorm	snowstorms
cemetery	cemeteries
pump	pumps
inconsistency	inconsistencies
badge	badges
mower	mowers
mass	masses
fairground	fairgrounds
flashback	flashbacks
fabrication	fabrications
note	notes
knock	knocks
indictment	indictments
zero	zeros
foreigner	foreigners
roar	roars
pitch	pitches
flex	flexes
punchline	punchlines
mirage	mirages
burn	burns
gunner	gunners
creditor	creditors
night	nights
zip	zips
haul	hauls
infection	infections
cougar	cougars
opener	openers
bend	bends
academician	academicians
stock	stocks
sentinel	sentinels
homily	homilies
bribe	bribes
stab	stabs
beret	berets
palace	palaces
nostril	nostrils
muffin	muffins
exclamation	exclamations
conga	congas
bud	buds
ism	isms
ritual	rituals
delinquency	delinquencies
boast	boasts
ball	balls
gunboat	gunboats
acid	acids
disk	disks
removal	removals
plague	plagues
push	pushes
encounter	encounters
signal	signals
fairy	fairies
epitaph	epitaphs
swimsuit	swimsuits
maiden	maidens
songbird	songbirds
fleck	flecks
foot	foots
yuppie	yuppies
canteen	canteens
slash	slashes
ratio	ratios
lining	linings
platoon	platoons
prosthesis	prostheses
governor	governors
longshoreman	longshoremen
commendation	commendations
sliver	slivers
hallmark	hallmarks
flock	flocks
informer	informers
numeral	numerals
guitar	guitars
funeral	funerals
image	images
implication	implications
mansion	mansions
superman	supermen
exchange	exchanges
perception	perceptions
if	ifs
success	successes
imagination	imaginations
shelf	shelves
panther	panthers
brood	broods
locust	locusts
norm	norms
bolt	bolts
chair	chairs
plumber	plumbers
yardstick	yardsticks
ruffle	ruffles
gallon	gallons
dreamer	dreamers
sniper	snipers
generalization	generalizations
slaying	slayings
walk	walks
stretcher	stretchers
reminder	reminders
spectacle	spectacles
cayman	caymans
theatre	theatres
warrior	warriors
kick	kicks
giant	giants
explorer	explorers
jingle	jingles
jelly	jellies
street	streets
azalea	azaleas
tort	torts
stewardess	stewardesses
advancement	advancements
hierarchy	hierarchies
chevron	chevrons
quiz	quizzes
surfer	surfers
lick	licks
pet	pets
tyrant	tyrants
linguist	linguists
waiter	waiters
grandson	grandsons
width	widths
buffalo	buffaloes
blue	blues
cohort	cohorts
timetable	timetables
sail	sails
civilization	civilizations
consulate	consulates
lever	levers
wizard	wizards
subtlety	subtleties
configuration	configurations
supermodel	supermodels
libertarian	libertarians
farewell	farewells
dot	dots
parlor	parlors
notion	notions
region	regions
caste	castes
altar	altars
occasion	occasions
province	provinces
stove	stoves
pinch	pinches
episode	episodes
ceasefire	ceasefires
jay	jays
neophyte	neophytes
superstition	superstitions
member	members
abnormality	abnormalities
assignment	assignments
post	posts
adverb	adverbs
bagel	bagels
constant	constants
motel	motels
transaction	transactions
cafeteria	cafeterias
creed	creeds
alleyway	alleyways
presidency	presidencies
edition	editions
facility	facilities
atlas	atlases
commute	commutes
relative	relatives
paratrooper	paratroopers
buttock	buttocks
wave	waves
array	arrays
promo	promos
rage	rages
cigarette	cigarettes
filter	filters
hospital	hospitals
hernia	hernias
tally	tallies
processor	processors
escort	escorts
defibrillator	defibrillators
telegram	telegrams
collision	collisions
sweeper	sweepers
market	markets
playmate	playmates
cache	caches
doer	doers
delegate	delegates
writer	writers
island	islands
envoy	envoys
derrick	derricks
industry	industries
falsehood	falsehoods
cinema	cinemas
microwave	microwaves
friction	frictions
school	schools
goody	goodies
skier	skiers
mouthpiece	mouthpieces
bookshelf	bookshelves
viper	vipers
donkey	donkeys
mullah	mullahs
awning	awnings
commentator	commentators
bod	bodes
pal	pales
hart	harts
stereo	stereos
district	districts
half	halves
following	followings
import	imports
racer	racers
barge	barges
relic	relics
influence	influences
keeper	keepers
walker	walkers
regime	regimes
caucus	caucuses
illustrator	illustrators
ripple	ripples
exploit	exploits
royalist	royalists
bench	benches
marking	markings
pregnancy	pregnancies
analyst	analysts
bastion	bastions
necktie	neckties
beat	beats
tic	tics
chancellor	chancellors
fee	fees
ordinance	ordinances
poison	poisons
consumer	consumers
pillar	pillars
figurine	figurines
clown	clowns
tax	taxes
veterinarian	veterinarians
receipt	receipts
tassel	tassels
luxury	luxuries
royalty	royalties
violet	violets
lobster	lobsters
goose	geese
convert	converts
knuckle	knuckles
thing	things
aberration	aberrations
anecdote	anecdotes
single	singles
innovation	innovations
sect	sects
attendant	attendants
supremacist	supremacists
nameplate	nameplates
pirate	pirates
mayor	mayors
prescription	prescriptions
diversion	diversions
army	armies
wreck	wrecks
screen	screens
span	spans
gala	galas
mountaineer	mountaineers
try	tries
abolitionist	abolitionists
hanger	hangers
coating	coatings
cairn	cairns
sky	skies
admission	admissions
name	names
cub	cubs
brownfield	brownfields
tub	tubes
fret	frets
disagreement	disagreements
superstar	superstars
crane	cranes
leader	leaders
misadventure	misadventures
crewman	crewmen
kingpin	kingpins
observer	observers
sex	sexes
tuner	tuners
rerun	reruns
berth	berths
car	cars
effect	effects
birdie	birdies
swarm	swarms
bombing	bombings
caravan	caravans
nurse	nurses
enforcer	enforcers
stand	stands
referendum	referendums
trestle	trestles
bumper	bumpers
scam	scams
die	dies
manipulator	manipulators
tender	tenders
foot	feet
anthem	anthems
spreadsheet	spreadsheets
archive	archives
opinion	opinions
missile	missiles
transformer	transformers
eraser	erasers
coordinator	coordinators
part	parts
academic	academics
recorder	recorders
commentary	commentaries
peg	pegs
turner	turners
ride	rides
loop	loops
chase	chases
mutant	mutants
groove	grooves
nuke	nukes
freedom	freedoms
handkerchief	handkerchiefs
path	paths
flag	flags
giggle	giggles
shaft	shafts
ewe	ewes
spic	spices
spokesman	spokesmen
fundraiser	fundraisers
parent	parents
consonant	consonants
washer	washers
lawsuit	lawsuits
spiritual	spirituals
gallery	galleries
sedan	sedans
pass	passes
match	matches
abuse	abuses
crayon	crayons
seagull	seagulls
rook	rooks
sea	seas
haircut	haircuts
burden	burdens
puppet	puppets
man	mans
cope	copes
chum	chums
hillbilly	hillbillies
urchin	urchins
dance	dances
burrito	burritos
graft	grafts
probe	probes
gill	gills
peddler	peddlers
whale	whales
sentry	sentries
compromise	compromises
sentence	sentences
copy	copies
cry	cries
signatory	signatories
referral	referrals
caisson	caissons
powerhouse	powerhouses
ache	aches
miss	misses
mind	minds
taunt	taunts
panda	pandas
trumpeter	trumpeters
cherry	cherries
robe	robes
fort	forts
archipelago	archipelagos
pint	pints
leap	leaps
parishioner	parishioners
divide	divides
pulse	pulses
allocation	allocations
magistrate	magistrates
utility	utilities
girl	girls
splash	splashes
howitzer	howitzers
patriarch	patriarchs
jurist	jurists
apartment	apartments
harp	harps
liquid	liquids
agent	agents
retriever	retrievers
intern	interns
pelican	pelicans
alum	alums
petition	petitions
financier	financiers
aerosol	aerosols
slip	slips
fancy	fancies
shareholding	shareholdings
quadrant	quadrants
embassy	embassies
constituent	constituents
technology	technologies
detector	detectors
teen	teens
termite	termites
disguise	disguises
asterisk	asterisks
fraternity	fraternities
rake	rakes
blow	blows
biologist	biologists
john	johns
refund	refunds
mound	mounds
sharp	sharps
cockroach	cockroaches
circus	circuses
fossil	fossils
castle	castles
dart	darts
freighter	freighters
beauty	beauties
tornado	tornadoes
nephew	nephews
sticker	stickers
calf	calves
cataract	cataracts
astrologer	astrologers
brow	brows
farm	farms
blessing	blessings
quote	quotes
reaction	reactions
zoologist	zoologists
noise	noises
operation	operations
lung	lungs
squeak	squeaks
barrage	barrages
infant	infants
migrant	migrants
conditioner	conditioners
peculiarity	peculiarities
rave	raves
spare	spares
hoop	hoops
speculator	speculators
girlfriend	girlfriends
sentiment	sentiments
trailer	trailers
speculation	speculations
guardsman	guardsmen
pacemaker	pacemakers
narrative	narratives
witness	witnesses
swirl	swirls
deduction	deductions
hors	horses
locker	lockers
quasar	quasars
run	runs
cleric	clerics
tomb	tombs
eleven	elevens
animosity	animosities
drop	drops
commander	commanders
gratuity	gratuities
piston	pistons
neurosis	neuroses
drum	drums
tank	tanks
agenda	agendas
invite	invites
carpenter	carpenters
heron	herons
survivor	survivors
morning	mornings
payload	payloads
videotape	videotapes
suffering	sufferings
reef	reefs
raccoon	raccoons
thousand	thousands
ton	tons
discard	discards
physician	physicians
realignment	realignments
curriculum	curricula
sucker	suckers
gag	gags
tenth	tenths
subscription	subscriptions
anxiety	anxieties
public	publics
duckling	ducklings
benchmark	benchmarks
flash	flashes
green	greens
corner	corners
pause	pauses
cellar	cellars
taxi	taxis
connection	connections
start	starts
piano	pianos
disorder	disorders
firearm	firearms
classification	classifications
energy	energies
expletive	expletives
cam	cams
widget	widgets
conference	conferences
blanket	blankets
dancer	dancers
row	rows
pane	panes
dinner	dinners
plug	plugs
pipeline	pipelines
triangle	triangles
overture	overtures
con	cons
boot	boots
election	elections
pimp	pimps
terrace	terraces
dugout	dugouts
covenant	covenants
payment	payments
specialist	specialists
chestnut	chestnuts
diocese	dioceses
sphere	spheres
spot	spots
syringe	syringes
bottle	bottles
extract	extracts
safari	safaris
map	maps
sock	socks
beetle	beetles
accident	accidents
railroad	railroads
podium	podiums
suffix	suffixes
cavern	caverns
evergreen	evergreens
firefighter	firefighters
chiropractor	chiropractors
transparency	transparencies
posse	posses
poppy	poppies
this	these
reply	replies
cookie	cookies
honeybee	honeybees
inhabitant	inhabitants
checklist	checklists
pound	pounds
visionary	visionaries
rooster	roosters
plastic	plastics
nibble	nibbles
priestess	priestesses
islander	islanders
crease	creases
dam	dams
diner	diners
firebomb	firebombs
printer	printers
grandstand	grandstands
loophole	loopholes
shortfall	shortfalls
casualty	casualties
brewery	breweries
vocabulary	vocabularies
tuck	tucks
nightclub	nightclubs
ash	ashes
stalwart	stalwarts
checker	checkers
devotee	devotees
evangelist	evangelists
resolution	resolutions
comic	comics
scrape	scrapes
risk	risks
scheme	schemes
cog	cogs
yellow	yellows
cashier	cashiers
talon	talons
commodity	commodities
inspection	inspections
ski	skis
receiver	receivers
mount	mounts
grip	grips
exaggeration	exaggerations
feature	features
transfusion	transfusions
hoax	hoaxes
staffer	staffers
heroine	heroines
antihistamine	antihistamines
spa	spas
tense	tenses
chord	chords
mat	mates
example	examples
charge	charges
pullback	pullbacks
gibbon	gibbons
publisher	publishers
score	scores
feud	feuds
alligator	alligators
intensity	intensities
guide	guides
reference	references
glimmer	glimmers
smoker	smokers
format	formats
tot	tots
delinquent	delinquents
shock	shocks
stake	stakes
beginner	beginners
pol	poles
inhaler	inhalers
pore	pores
beverage	beverages
objective	objectives
keyboard	keyboards
indication	indications
boxer	boxers
sausage	sausages
stem	stems
patron	patrons
advantage	advantages
wildfire	wildfires
discounter	discounters
brief	briefs
grave	graves
rod	rods
backlog	backlogs
master	masters
lapel	lapels
pod	pods
swoop	swoops
creep	creeps
banana	bananas
hundred	hundreds
kickback	kickbacks
mag	mags
defeat	defeats
wrapper	wrappers
deck	decks
handset	handsets
symphony	symphonies
supercomputer	supercomputers
groan	groans
periodical	periodicals
twist	twists
monopoly	monopolies
burro	burros
tech	techs
elbow	elbows
siege	sieges
objector	objectors
hopper	hoppers
pizza	pizzas
perversion	perversions
expenditure	expenditures
hornet	hornets
repression	repressions
technocrat	technocrats
toll	tolls
backpack	backpacks
precedent	precedents
conductor	conductors
aviator	aviators
carload	carloads
pigment	pigments
connoisseur	connoisseurs
fingertip	fingertips
needle	needles
ovary	ovaries
abstraction	abstractions
desktop	desktops
tout	touts
residence	residences
smokestack	smokestacks
bucket	buckets
sneeze	sneezes
swim	swims
plaza	plazas
stratum	strata
blast	blasts
enclosure	enclosures
exhibit	exhibits
hardship	hardships
eyewitness	eyewitnesses
cent	cents
blotch	blotches
spade	spades
tier	tiers
clot	clots
fountain	fountains
commissioner	commissioners
cocktail	cocktails
bartender	bartenders
assassin	assassins
rent	rents
tampon	tampons
eclipse	eclipses
label	labels
dumpling	dumplings
tap	tapes
surge	surges
condor	condors
ton	tones
clearance	clearances
window	windows
footprint	footprints
playground	playgrounds
kicker	kickers
skunk	skunks
gutter	gutters
government	governments
pumpkin	pumpkins
brook	brooks
appointment	appointments
aptitude	aptitudes
termination	terminations
impropriety	improprieties
elder	elders
budget	budgets
racist	racists
execution	executions
savanna	savannas
consultation	consultations
iceberg	icebergs
memorial	memorials
vase	vases
chopper	choppers
puma	pumas
shark	sharks
domino	dominoes
sensibility	sensibilities
rider	riders
antenna	antennae
vendor	vendors
mama	mamas
ounce	ounces
anagram	anagrams
owl	owls
complexity	complexities
haystack	haystacks
orbit	orbits
margin	margins
pastime	pastimes
seedling	seedlings
meteor	meteors
shrine	shrines
spray	sprays
canine	canines
talkie	talkies
quarter	quarters
dude	dudes
grandmother	grandmothers
boycott	boycotts
curse	curses
synthesizer	synthesizers
undergarment	undergarments
code	codes
delta	deltas
landmark	landmarks
coil	coils
manatee	manatees
testimony	testimonies
mafioso	mafiosi
soil	soils
godfather	godfathers
adjective	adjectives
mouse	mice
calendar	calendars
pal	pals
neutron	neutrons
similarity	similarities
strait	straits
grad	grades
bypass	bypasses
kennel	kennels
relapse	relapses
vote	votes
inch	inches
goddess	goddesses
rate	rates
aphorism	aphorisms
complement	complements
autobiography	autobiographies
investigator	investigators
aunt	aunts
renegade	renegades
honor	honors
entitlement	entitlements
plot	plots
closure	closures
stitch	stitches
container	containers
offshoot	offshoots
interval	intervals
record	records
limb	limbs
guidebook	guidebooks
mule	mules
switch	switches
robot	robots
multiplex	multiplexes
orchid	orchids
hick	hicks
logger	loggers
multitude	multitudes
intrusion	intrusions
prize	prizes
fence	fences
crackdown	crackdowns
limousine	limousines
dropout	dropouts
executioner	executioners
suite	suites
dictator	dictators
tusk	tusks
module	modules
detail	details
confession	confessions
sophomore	sophomores
teacher	teachers
diuretic	diuretics
trail	trails
prospectus	prospectuses
eighth	eighths
novelist	novelists
cheer	cheers
safeguard	safeguards
healer	healers
lottery	lotteries
correlate	correlates
private	privates
variant	variants
surrogate	surrogates
field	fields
globe	globes
belly	bellies
outfit	outfits
fox	foxes
slope	slopes
blueberry	blueberries
soda	sodas
cassette	cassettes
moan	moans
sister	sisters
expectation	expectations
antenna	antennas
vent	vents
manifest	manifests
comment	comments
quartet	quartets
Negro	Negroes
seminar	seminars
salamander	salamanders
breach	breaches
amount	amounts
study	studies
bag	bags
eight	eights
ruling	rulings
trunk	trunks
silhouette	silhouettes
vein	veins
rim	rims
document	documents
proof	proofs
toilet	toilets
regulation	regulations
raven	ravens
mercenary	mercenaries
punter	punters
emissary	emissaries
coastline	coastlines
mask	masks
tea	teas
lorry	lorries
cactus	cacti
addiction	addictions
sign	signs
conflict	conflicts
barney	barneys
canoe	canoes
complaint	complaints
well	wells
account	accounts
pointer	pointers
usher	ushers
bugle	bugles
penny	pence
listener	listeners
stylist	stylists
vocation	vocations
condiment	condiments
anesthetic	anesthetics
bedroom	bedrooms
strand	strands
antidote	antidotes
trek	treks
bootleg	bootlegs
structure	structures
winger	wingers
lump	lumps
tutor	tutors
mosaic	mosaics
caliph	caliphs
scent	scents
shipyard	shipyards
spec	specs
machine	machines
cheetah	cheetahs
plea	pleas
saddle	saddles
shanty	shanties
initiate	initiates
rite	rites
cover	covers
nucleus	nuclei
outage	outages
brochure	brochures
obstetrician	obstetricians
rodent	rodents
methodology	methodologies
backbone	backbones
spree	sprees
minister	ministers
squirrel	squirrels
swede	swedes
advocate	advocates
despot	despots
junkie	junkies
hiker	hikers
native	natives
passenger	passengers
eatery	eateries
vegetarian	vegetarians
shopper	shoppers
airplane	airplanes
transition	transitions
insect	insects
approval	approvals
urn	urns
cable	cables
homicide	homicides
bloodline	bloodlines
state	states
coalition	coalitions
wearer	wearers
happening	happenings
decoration	decorations
instance	instances
explosive	explosives
drip	drips
radio	radios
apprehension	apprehensions
conspiracy	conspiracies
query	queries
capsule	capsules
ration	rations
cost	costs
umbrella	umbrellas
taboo	taboos
smear	smears
march	marches
rebel	rebels
chapel	chapels
originator	originators
classic	classics
martyr	martyrs
pervert	perverts
breeze	breezes
instructor	instructors
gasp	gasps
multiple	multiples
trader	traders
corporation	corporations
sting	stings
duel	duels
trick	tricks
homeland	homelands
partisan	partisans
commitment	commitments
stroller	strollers
debater	debaters
directive	directives
evaluation	evaluations
cough	coughs
deserter	deserters
knockout	knockouts
faction	factions
benefactor	benefactors
lock	locks
skin	skins
socialite	socialites
rabbit	rabbits
legislator	legislators
carcinogen	carcinogens
fax	faxes
hurricane	hurricanes
subversive	subversives
vista	vistas
composite	composites
hooker	hookers
walrus	walruses
goat	goats
liver	livers
shake	shakes
chat	chats
abrasion	abrasions
do	does
jetliner	jetliners
potato	potatoes
sweetener	sweeteners
tree	trees
spore	spores
total	totals
complex	complexes
surcharge	surcharges
trauma	traumas
wound	wounds
layout	layouts
chamber	chambers
mop	mops
judge	judges
euro	euros
proponent	proponents
razor	razors
brain	brains
knot	knots
pothole	potholes
starch	starches
mom	moms
overlap	overlaps
pusher	pushers
swan	swans
initial	initials
amateur	amateurs
sandal	sandals
hint	hints
stripe	stripes
megawatt	megawatts
walkout	walkouts
shell	shells
ballad	ballads
chairman	chairmen
stalker	stalkers
blockage	blockages
gator	gators
nude	nudes
camcorder	camcorders
proclamation	proclamations
resignation	resignations
dislike	dislikes
tripod	tripods
corridor	corridors
impact	impacts
shampoo	shampoos
justification	justifications
salon	salons
peacock	peacocks
cave	caves
viewpoint	viewpoints
buzzard	buzzards
cocoon	cocoons
caretaker	caretakers
associate	associates
scapegoat	scapegoats
embrace	embraces
repellent	repellents
difficulty	difficulties
hanging	hangings
cadre	cadres
snack	snacks
hectare	hectares
satellite	satellites
primate	primates
chapter	chapters
sermon	sermons
pioneer	pioneers
telescope	telescopes
locomotive	locomotives
dialogue	dialogues
vestige	vestiges
insight	insights
freezer	freezers
ballroom	ballrooms
flood	floods
jump	jumps
pan	pans
leopard	leopards
pueblo	pueblos
fusion	fusions
thigh	thighs
whisker	whiskers
dissenter	dissenters
microorganism	microorganisms
breed	breeds
grate	grates
memorandum	memoranda
graph	graphs
restoration	restorations
sandbag	sandbags
ink	inks
outing	outings
fissure	fissures
hall	halls
nip	nips
warehouse	warehouses
spine	spines
hunter	hunters
aftershock	aftershocks
function	functions
phase	phases
advertisement	advertisements
cancer	cancers
fascist	fascists
surprise	surprises
plate	plates
mortgage	mortgages
thicket	thickets
cowgirl	cowgirls
juice	juices
participant	participants
antique	antiques
contestant	contestants
look	looks
join	joins
counterattack	counterattacks
string	strings
dud	dudes
letter	letters
fallacy	fallacies
purchase	purchases
dare	dares
dock	docks
salute	salutes
sighting	sightings
pyramid	pyramids
claw	claws
pylon	pylons
spokesperson	spokespersons
stamp	stamps
tortilla	tortillas
glimpse	glimpses
soul	souls
vet	vets
tide	tides
possum	possums
knight	knights
slab	slabs
calamity	calamities
squirt	squirts
correspondent	correspondents
husky	huskies
portfolio	portfolios
toddler	toddlers
loser	losers
distiller	distillers
roster	rosters
quark	quarks
invader	invaders
attack	attacks
career	careers
cure	cures
lullaby	lullabies
exclusion	exclusions
confrontation	confrontations
transponder	transponders
alter	alters
ligament	ligaments
cormorant	cormorants
activist	activists
goaltender	goaltenders
dummy	dummies
diva	divas
elector	electors
catch	catches
protest	protests
chronicle	chronicles
appearance	appearances
tag	tags
precipitate	precipitates
paw	paws
buffer	buffers
bit	bits
saw	saws
passerby	passersby
disadvantage	disadvantages
planet	planets
bottleneck	bottlenecks
estuary	estuaries
feat	feats
sense	senses
finish	finishes
egg	eggs
generation	generations
playwright	playwrights
scrap	scraps
arbiter	arbiters
stew	stews
riff	riffs
hallucination	hallucinations
indentation	indentations
sorority	sororities
cabbage	cabbages
beggar	beggars
blog	blogs
voyager	voyagers
son	sons
miner	miners
droplet	droplets
leaf	leafs
reduction	reductions
superpower	superpowers
hose	hoses
deficiency	deficiencies
agency	agencies
prompt	prompts
sore	sores
ray	rays
concerto	concertos
pavilion	pavilions
compress	compresses
vacancy	vacancies
mugging	muggings
alien	aliens
leech	leeches
campground	campgrounds
orientation	orientations
medallion	medallions
computation	computations
passage	passages
voyage	voyages
fellow	fellows
statute	statutes
seeker	seekers
condominium	condominiums
count	counts
bonus	bonuses
poisoning	poisonings
glide	glides
fog	fogs
pretzel	pretzels
assistant	assistants
roach	roaches
crater	craters
coup	coups
shipment	shipments
germ	germs
feminist	feminists
enthusiast	enthusiasts
custodian	custodians
check	checks
beau	beaux
backyard	backyards
rick	ricks
wasp	wasps
racquet	racquets
term	terms
list	lists
rat	rates
migration	migrations
solicitor	solicitors
homer	homers
parson	parsons
rescue	rescues
apricot	apricots
vanity	vanities
llama	llamas
hypothesis	hypotheses
welder	welders
swing	swings
den	dens
threshold	thresholds
rafter	rafters
agitator	agitators
seal	seals
imitation	imitations
illustration	illustrations
group	groups
canary	canaries
confederate	confederates
turn	turns
confirmation	confirmations
enterprise	enterprises
audit	audits
bloom	blooms
disappearance	disappearances
rep	reps
guess	guesses
fanatic	fanatics
medium	media
burrow	burrows
referee	referees
presentation	presentations
buzzer	buzzers
pest	pests
ferret	ferrets
event	events
increase	increases
biscuit	biscuits
protester	protesters
discount	discounts
bankruptcy	bankruptcies
gull	gulls
kilo	kilos
dwarf	dwarfs
fuse	fuses
synonym	synonyms
repository	repositories
pulley	pulleys
follicle	follicles
volley	volleys
highway	highways
gathering	gatherings
propeller	propellers
predator	predators
race	races
bay	bays
manifestation	manifestations
verse	verses
tissue	tissues
professor	professors
site	sites
fraction	fractions
drama	dramas
bloc	blocs
precursor	precursors
taco	tacos
curator	curators
Hindu	Hindus
pontoon	pontoons
walnut	walnuts
shout	shouts
binder	binders
dye	dyes
tour	tours
cartoonist	cartoonists
ventricle	ventricles
dosage	dosages
marlin	marlins
believer	believers
puppy	puppies
freak	freaks
ringer	ringers
paddy	paddies
intestine	intestines
block	blocks
emplacement	emplacements
tone	tones
buy	buys
murder	murders
boil	boils
sprinter	sprinters
palm	palms
assassination	assassinations
typhoon	typhoons
ninja	ninjas
mill	mills
arc	arcs
expert	experts
oriole	orioles
housewife	housewives
butcher	butchers
sinner	sinners
shower	showers
inheritance	inheritances
ledger	ledgers
scout	scouts
tournament	tournaments
urge	urges
widow	widows
analysis	analyses
contraceptive	contraceptives
live	lives
liberty	liberties
ridge	ridges
brand	brands
riot	riots
orator	orators
squatter	squatters
contraction	contractions
battalion	battalions
finch	finches
racketeer	racketeers
squad	squads
sympathy	sympathies
optometrist	optometrists
monarch	monarchs
repair	repairs
manger	mangers
accomplice	accomplices
oddity	oddities
purse	purses
booking	bookings
trickle	trickles
valve	valves
curtain	curtains
niece	nieces
ballplayer	ballplayers
award	awards
mathematician	mathematicians
porch	porches
groundhog	groundhogs
colonel	colonels
stallion	stallions
romance	romances
condom	condoms
competitor	competitors
galleon	galleons
laptop	laptops
hostage	hostages
lifeboat	lifeboats
islet	islets
interlude	interludes
hand	hands
barb	barbs
flamingo	flamingos
meet	meets
snatch	snatches
kook	kooks
defense	defenses
motorcycle	motorcycles
osprey	ospreys
fender	fenders
chore	chores
beaker	beakers
guarantor	guarantors
ideal	ideals
spring	springs
clam	clams
coast	coasts
foe	foes
desk	desks
orphan	orphans
sauna	saunas
party	parties
grape	grapes
jackal	jackals
gas	gases
mall	malls
university	universities
republican	republicans
shortage	shortages
liar	liars
amenity	amenities
system	systems
molecule	molecules
balloon	balloons
rivalry	rivalries
cooker	cookers
saxophone	saxophones
dune	dunes
heel	heels
assumption	assumptions
hustler	hustlers
column	columns
bikini	bikinis
snowmobile	snowmobiles
controversy	controversies
scab	scabs
burger	burgers
technicality	technicalities
monastery	monasteries
constitution	constitutions
commoner	commoners
tart	tarts
hump	humps
habitat	habitats
ion	ions
loaf	loaves
disruption	disruptions
founder	founders
bike	bikes
bang	bangs
secretion	secretions
adviser	advisers
lay	lays
beet	beets
wedge	wedges
panic	panics
divider	dividers
tractor	tractors
tunic	tunics
tunnel	tunnels
townhouse	townhouses
skipper	skippers
price	prices
visual	visuals
burner	burners
call	calls
glance	glances
cross	crosses
browser	browsers
daughter	daughters
directory	directories
spokesperson	spokespeople
overdose	overdoses
movie	movies
asset	assets
earner	earners
city	cities
feather	feathers
booster	boosters
activity	activities
supporter	supporters
task	tasks
vest	vests
vandal	vandals
artery	arteries
auditorium	auditoriums
toss	tosses
shot	shots
trace	traces
lurch	lurches
coroner	coroners
superconductor	superconductors
prophet	prophets
goblet	goblets
harvester	harvesters
channel	channels
superlative	superlatives
caricature	caricatures
chimney	chimneys
committee	committees
stink	stinks
leper	lepers
cutout	cutouts
boarder	boarders
dungeon	dungeons
afternoon	afternoons
extremity	extremities
handshake	handshakes
being	beings
bounce	bounces
flap	flaps
drove	droves
twitch	twitches
gazelle	gazelles
obscenity	obscenities
step	steps
linebacker	linebackers
maker	makers
agreement	agreements
sac	sacs
powder	powders
organism	organisms
rise	rises
surgery	surgeries
stairwell	stairwells
gadget	gadgets
escape	escapes
revolver	revolvers
attraction	attractions
implement	implements
pedestal	pedestals
inning	innings
jersey	jerseys
prion	prions
disease	diseases
corps	corpses
portable	portables
caper	capers
nest	nests
headhunter	headhunters
tenor	tenors
pearl	pearls
suture	sutures
streak	streaks
jungle	jungles
orgasm	orgasms
incinerator	incinerators
express	expresses
screenplay	screenplays
speed	speeds
torpedo	torpedoes
phenomenon	phenomena
resident	residents
buggy	buggies
constituency	constituencies
house	houses
canon	canons
disparity	disparities
autograph	autographs
shawl	shawls
contractor	contractors
throttle	throttles
lion	lions
portrayal	portrayals
quest	quests
fingernail	fingernails
fire	fires
guinea	guineas
thunderstorm	thunderstorms
biopsy	biopsies
detour	detours
form	forms
leaflet	leaflets
index	indexes
nudist	nudists
hurt	hurts
armament	armaments
aggregate	aggregates
twister	twisters
contract	contracts
melody	melodies
mountainside	mountainsides
barrel	barrels
watershed	watersheds
old	olds
rank	ranks
star	stars
scandal	scandals
requirement	requirements
ambiguity	ambiguities
struggle	struggles
gravestone	gravestones
franc	frances
sympathizer	sympathizers
ecologist	ecologists
yard	yards
undertone	undertones
holster	holsters
dome	domes
intellectual	intellectuals
campaign	campaigns
oath	oaths
crust	crusts
schedule	schedules
dialect	dialects
rhino	rhinos
fall	falls
pill	pills
horn	horns
portion	portions
choir	choirs
mudslide	mudslides
modem	modems
hamburger	hamburgers
detainee	detainees
prince	princes
lien	liens
marsh	marshes
deed	deeds
nightmare	nightmares
sculpture	sculptures
talent	talents
certificate	certificates
gun	guns
watchdog	watchdogs
noble	nobles
rancher	ranchers
device	devices
wasteland	wastelands
watcher	watchers
photographer	photographers
rapper	rappers
overlay	overlays
jock	jocks
zone	zones
dweller	dwellers
mustang	mustangs
merit	merits
absolute	absolutes
slit	slits
invoice	invoices
mascot	mascots
drought	droughts
verdict	verdicts
medic	medics
court	courts
jam	james
bystander	bystanders
mammoth	mammoths
quiver	quivers
prayer	prayers
bureaucracy	bureaucracies
fluid	fluids
skylight	skylights
hero	heroes
investment	investments
artist	artists
guard	guards
reed	reeds
basis	bases
poem	poems
cabinet	cabinets
impersonator	impersonators
oilfield	oilfields
polemic	polemics
rectangle	rectangles
attempt	attempts
dagger	daggers
basin	basins
lap	laps
percentage	percentages
soloist	soloists
mooring	moorings
parcel	parcels
abortion	abortions
itinerary	itineraries
father	fathers
affiliation	affiliations
western	westerns
bachelor	bachelors
dishwasher	dishwashers
upload	uploads
adult	adults
streetcar	streetcars
oasis	oases
microbe	microbes
pro	pros
rhyme	rhymes
lash	lashes
wind	winds
newscast	newscasts
crook	crooks
camera	cameras
black	blacks
cornerstone	cornerstones
veto	vetoes
lead	leads
spacewalk	spacewalks
drawing	drawings
fowl	fowls
outcome	outcomes
rendering	renderings
intricacy	intricacies
keep	keeps
illegal	illegals
bead	beads
contraption	contraptions
back	backs
drag	drags
bob	bobs
apologist	apologists
feline	felines
mole	moles
admirer	admirers
story	stories
duct	ducts
bandage	bandages
lie	lies
hero	heros
entrepreneur	entrepreneurs
ruby	rubies
embryo	embryos
tramp	tramps
remark	remarks
thief	thieves
psalm	psalms
topic	topics
baptism	baptisms
facet	facets
galley	galleys
corpse	corpses
tavern	taverns
enclave	enclaves
jet	jets
nose	noses
groupie	groupies
takeover	takeovers
taxiway	taxiways
antecedent	antecedents
aficionado	aficionados
counterpart	counterparts
nook	nooks
indiscretion	indiscretions
tuft	tufts
loyalty	loyalties
beacon	beacons
shin	shines
wipe	wipes
boutique	boutiques
planeload	planeloads
prism	prisms
garrison	garrisons
slice	slices
upper	uppers
polyp	polyps
eater	eaters
pond	ponds
hound	hounds
child	childs
canyon	canyons
quill	quills
jibe	jibes
adversary	adversaries
gunman	gunmen
rally	rallies
brothel	brothels
improvement	improvements
clash	clashes
nation	nations
deficit	deficits
department	departments
cult	cults
stir	stirs
penetration	penetrations
chain	chains
bazaar	bazaars
cradle	cradles
pathway	pathways
crisis	crises
euphemism	euphemisms
representative	representatives
quilt	quilts
cage	cages
hook	hooks
separatist	separatists
organ	organs
card	cards
sensation	sensations
teenager	teenagers
airliner	airliners
college	colleges
hack	hacks
tear	tears
ambition	ambitions
walkway	walkways
turnip	turnips
republic	republics
dentist	dentists
calorie	calories
ovation	ovations
picture	pictures
predecessor	predecessors
wicket	wickets
transfer	transfers
perfume	perfumes
monitor	monitors
hour	hours
bush	bushes
antibody	antibodies
shoot	shoots
breeder	breeders
tooth	teeth
tantrum	tantrums
catcher	catchers
magazine	magazines
bridesmaid	bridesmaids
article	articles
resort	resorts
backdrop	backdrops
red	reds
headline	headlines
shepherd	shepherds
brick	bricks
obituary	obituaries
puritan	puritans
contrast	contrasts
lunch	lunches
fisherman	fishermen
excursion	excursions
tick	ticks
boulevard	boulevards
root	roots
fable	fables
carousel	carousels
tribute	tributes
biker	bikers
purge	purges
demonstration	demonstrations
contest	contests
mummy	mummies
willow	willows
chart	charts
bombardment	bombardments
canister	canisters
roof	roofs
computer	computers
whip	whips
surround	surrounds
respondent	respondents
diary	diaries
fishery	fisheries
bog	bogs
sonnet	sonnets
hopeful	hopefuls
clergyman	clergymen
moth	moths
suit	suits
personage	personages
motorist	motorists
congress	congresses
fireplace	fireplaces
abstention	abstentions
vowel	vowels
anarchist	anarchists
sack	sacks
lady	ladies
approximation	approximations
cavity	cavities
atom	atoms
composer	composers
electrode	electrodes
woman	women
pebble	pebbles
reagent	reagents
kettle	kettles
concession	concessions
levee	levees
ideologue	ideologues
locus	loci
weld	welds
dossier	dossiers
antioxidant	antioxidants
ranch	ranches
nigger	niggers
disability	disabilities
chemist	chemists
gaffe	gaffes
lesson	lessons
veteran	veterans
undergraduate	undergraduates
nut	nuts
person	persons
premonition	premonitions
shaker	shakers
heart	hearts
collector	collectors
campsite	campsites
whore	whores
spectator	spectators
net	nets
foul	fouls
crate	crates
painting	paintings
nationalist	nationalists
performer	performers
audience	audiences
boxcar	boxcars
exhaust	exhausts
grand	grands
wallet	wallets
moderator	moderators
treatise	treatises
refugee	refugees
settler	settlers
dealership	dealerships
vaccine	vaccines
colonial	colonials
win	wins
cock	cocks
pauper	paupers
peripheral	peripherals
tribesman	tribesmen
distraction	distractions
tent	tents
trait	traits
latch	latches
monologue	monologues
tenant	tenants
alumnus	alumni
spat	spats
extraterrestrial	extraterrestrials
typewriter	typewriters
op	ops
mobster	mobsters
truckload	truckloads
bouncer	bouncers
curiosity	curiosities
pony	ponies
overlord	overlords
monarchist	monarchists
redneck	rednecks
wildcat	wildcats
rainbow	rainbows
semiconductor	semiconductors
waitress	waitresses
feed	feeds
clamp	clamps
serial	serials
logo	logos
rental	rentals
can	cans
road	roads
diet	diets
dictionary	dictionaries
pandemic	pandemics
diehard	diehards
tie	ties
peer	peers
toy	toys
ringleader	ringleaders
remove	removes
shovel	shovels
advertiser	advertisers
bale	bales
informant	informants
gent	gents
outpost	outposts
five	fives
regret	regrets
convertible	convertibles
affliction	afflictions
amnesty	amnesties
finalist	finalists
imprint	imprints
fine	fines
fin	fins
burial	burials
forehead	foreheads
isotope	isotopes
crocodile	crocodiles
greenhouse	greenhouses
pavement	pavements
photon	photons
honoree	honorees
jaguar	jaguars
chemical	chemicals
designer	designers
crop	crops
subcontractor	subcontractors
casket	caskets
marathon	marathons
garden	gardens
rejection	rejections
ditch	ditches
sitter	sitters
clump	clumps
heifer	heifers
incident	incidents
rocket	rockets
warhead	warheads
landscape	landscapes
orchestra	orchestras
blazer	blazers
tulip	tulips
lover	lovers
treat	treats
stump	stumps
witch	witches
zealot	zealots
marsupial	marsupials
four	fours
weekend	weekends
whim	whims
slap	slaps
process	processes
book	books
testament	testaments
glob	globes
raspberry	raspberries
horseman	horsemen
interchange	interchanges
paragraph	paragraphs
blender	blenders
operative	operatives
enemy	enemies
phrase	phrases
spurt	spurts
lemming	lemmings
octave	octaves
expressway	expressways
candidate	candidates
apprenticeship	apprenticeships
jealousy	jealousies
sensor	sensors
pear	pears
teamster	teamsters
characterization	characterizations
textbook	textbooks
absentee	absentees
foodstuff	foodstuffs
mason	masons
analogy	analogies
vertebra	vertebrae
slide	slides
customer	customers
adventure	adventures
charger	chargers
macaw	macaws
philanthropist	philanthropists
blackout	blackouts
liner	liners
downer	downers
institution	institutions
musical	musicals
oxide	oxides
tribulation	tribulations
museum	museums
director	directors
piper	pipers
sneak	sneaks
rattle	rattles
isle	isles
depot	depots
missionary	missionaries
beam	beams
triad	triads
ear	ears
puncture	punctures
visor	visors
sewer	sewers
distillery	distilleries
battlefield	battlefields
invention	inventions
revelation	revelations
harpoon	harpoons
bandit	bandits
billboard	billboards
sound	sounds
therapist	therapists
heretic	heretics
lantern	lanterns
airfare	airfares
pharmacist	pharmacists
Frenchman	Frenchmen
throw	throws
distributor	distributors
zoo	zoos
nitrate	nitrates
nutritionist	nutritionists
interviewer	interviewers
pa	pas
expo	expos
garment	garments
profit	profits
bulge	bulges
weave	weaves
basque	basques
borrower	borrowers
killing	killings
bookseller	booksellers
offering	offerings
dispatcher	dispatchers
crutch	crutches
schoolmate	schoolmates
stag	stages
capacity	capacities
database	databases
tram	trams
pack	packs
climax	climaxes
antagonist	antagonists
curl	curls
skull	skulls
accolade	accolades
reputation	reputations
jukebox	jukeboxes
pogrom	pogroms
storm	storms
specification	specifications
scooter	scooters
dorm	dorms
extinguisher	extinguishers
perk	perks
successor	successors
songwriter	songwriters
attribute	attributes
sweep	sweeps
test	tests
quake	quakes
jab	jabs
rarity	rarities
flare	flares
fake	fakes
hope	hopes
vacation	vacations
memory	memories
schoolgirl	schoolgirls
socket	sockets
mountaintop	mountaintops
psychiatrist	psychiatrists
revolutionary	revolutionaries
altercation	altercations
depositor	depositors
reviewer	reviewers
friendship	friendships
dependency	dependencies
inquiry	inquiries
stunt	stunts
restaurant	restaurants
therapy	therapies
innovator	innovators
beatnik	beatniks
meat	meats
trophy	trophies
puddle	puddles
cop	cops
paddle	paddles
disposition	dispositions
amputee	amputees
bowler	bowlers
gorge	gorges
reserve	reserves
showgirl	showgirls
examiner	examiners
murmur	murmurs
present	presents
scroll	scrolls
kink	kinks
faculty	faculties
mutiny	mutinies
apprentice	apprentices
kickoff	kickoffs
impression	impressions
continent	continents
carcass	carcasses
identity	identities
measurement	measurements
gender	genders
raisin	raisins
dad	dads
low	lows
tool	tools
invasion	invasions
parade	parades
mantra	mantras
aspirant	aspirants
vigilante	vigilantes
bureaucrat	bureaucrats
tribe	tribes
moderate	moderates
gargoyle	gargoyles
vampire	vampires
cartel	cartels
inventory	inventories
telephone	telephones
deadline	deadlines
inaccuracy	inaccuracies
maze	mazes
property	properties
rap	raps
genotype	genotypes
chant	chants
household	households
brake	brakes
approach	approaches
barn	barnes
train	trains
ultimatum	ultimatums
blimp	blimps
obligation	obligations
clan	clans
electrolyte	electrolytes
sow	sows
dynasty	dynasties
bonfire	bonfires
kernel	kernels
bat	bats
head	heads
man	men
newsstand	newsstands
choice	choices
muse	muses
bristle	bristles
violation	violations
defender	defenders
bookstore	bookstores
stile	stiles
livelihood	livelihoods
cat	cates
residue	residues
sibling	siblings
booth	booths
receptor	receptors
councilman	councilmen
shift	shifts
president	presidents
clinch	clinches
aircraft	aircrafts
tabloid	tabloids
town	towns
mechanic	mechanics
hillside	hillsides
newsroom	newsrooms
division	divisions
houseboat	houseboats
scientist	scientists
ruler	rulers
fry	fries
scalp	scalps
sole	soles
diaper	diapers
vacuum	vacuums
outlet	outlets
spiral	spirals
cannon	cannons
ape	apes
bishop	bishops
plotter	plotters
disincentive	disincentives
insult	insults
legislature	legislatures
caster	casters
utensil	utensils
cadet	cadets
gangster	gangsters
monument	monuments
grotto	grottoes
farmhouse	farmhouses
snipe	snipes
worry	worries
tyke	tykes
minute	minutes
explosion	explosions
superior	superiors
shamrock	shamrocks
journal	journals
escapade	escapades
tug	tugs
birthday	birthdays
dawn	dawns
sufferer	sufferers
recruit	recruits
chief	chiefs
pollutant	pollutants
flake	flakes
flower	flowers
drummer	drummers
wallaby	wallabies
treasurer	treasurers
doc	docs
glacier	glaciers
fiend	fiends
hide	hides
marketplace	marketplaces
sitcom	sitcoms
infusion	infusions
eyeball	eyeballs
vat	vats
astronomer	astronomers
buddy	buddies
alteration	alterations
baboon	baboons
irregular	irregulars
television	televisions
trial	trials
closet	closets
disturbance	disturbances
place	places
ace	aces
carnivore	carnivores
steed	steeds
duke	dukes
clause	clauses
hydrant	hydrants
undesirable	undesirables
cola	colas
thriller	thrillers
mourner	mourners
chaplain	chaplains
cooper	coopers
uncle	uncles
solvent	solvents
manhunt	manhunts
texture	textures
rift	rifts
encyclopedia	encyclopedias
crest	crests
policeman	policemen
arsonist	arsonists
beachhead	beachheads
caveat	caveats
dictate	dictates
whistle	whistles
landing	landings
flight	flights
hulk	hulks
prod	prods
daredevil	daredevils
cutting	cuttings
calculator	calculators
flipper	flippers
dessert	desserts
observatory	observatories
find	finds
nail	nails
muscle	muscles
billion	billions
fix	fixes
toot	toots
expulsion	expulsions
complication	complications
individual	individuals
close	closes
film	films
masterpiece	masterpieces
cramp	cramps
boardroom	boardrooms
peak	peaks
lyricist	lyricists
seat	seats
adjustment	adjustments
universe	universes
appetizer	appetizers
epithet	epithets
cobblestone	cobblestones
subsidy	subsidies
chariot	chariots
ledge	ledges
laser	lasers
spin	spins
service	services
stadium	stadiums
target	targets
manager	managers
question	questions
trouble	troubles
inmate	inmates
harvest	harvests
association	associations
poodle	poodles
midget	midgets
youngster	youngsters
research	researches
bullet	bullets
pencil	pencils
setback	setbacks
swab	swabs
gunfight	gunfights
kite	kites
fitting	fittings
pew	pews
vegetable	vegetables
pianist	pianists
fare	fares
county	counties
vibration	vibrations
troublemaker	troublemakers
determinant	determinants
glove	gloves
delay	delays
detonator	detonators
newscaster	newscasters
clerk	clerks
life	lives
spoke	spokes
entanglement	entanglements
fact	facts
local	locals
fluke	flukes
stork	storks
truffle	truffles
allergy	allergies
conglomerate	conglomerates
number	numbers
eel	eels
chorus	choruses
vitamin	vitamins
veil	veils
driveway	driveways
bunny	bunnies
niche	niches
wad	wads
offender	offenders
age	ages
pitfall	pitfalls
citizen	citizens
reel	reels
dolphin	dolphins
diabetic	diabetics
tremor	tremors
padre	padres
crack	cracks
disclosure	disclosures
seam	seams
subcommittee	subcommittees
caterer	caterers
orgy	orgies
nomad	nomads
prerequisite	prerequisites
simulator	simulators
reactor	reactors
supplier	suppliers
inadequacy	inadequacies
outsider	outsiders
locality	localities
discrepancy	discrepancies
lollipop	lollipops
response	responses
bump	bumps
appeal	appeals
polymer	polymers
obstacle	obstacles
champion	champions
version	versions
chairperson	chairpersons
extremist	extremists
patrol	patrols
redwood	redwoods
quotation	quotations
litigant	litigants
solo	solos
cartridge	cartridges
national	nationals
rationale	rationales
minnow	minnows
nutrient	nutrients
automaker	automakers
exploration	explorations
clarinet	clarinets
origin	origins
squall	squalls
dig	digs
taper	tapers
yacht	yachts
color	colors
programmer	programmers
timer	timers
gulag	gulags
mist	mists
wrestler	wrestlers
nag	nags
fresco	frescoes
infinitive	infinitives
description	descriptions
rivet	rivets
chest	chests
denunciation	denunciations
clarification	clarifications
conduit	conduits
achiever	achievers
sauce	sauces
inscription	inscriptions
trap	traps
petrochemical	petrochemicals
hologram	holograms
moral	morales
wreath	wreaths
boundary	boundaries
verge	verges
human	humans
bough	boughs
fragment	fragments
domestic	domestics
workman	workmen
hippo	hippos
constructor	constructors
gentile	gentiles
spectrum	spectra
gorilla	gorillas
hive	hives
swastika	swastikas
paperback	paperbacks
filler	fillers
nickname	nicknames
play	plays
rape	rapes
combo	combos
saver	savers
investor	investors
aspiration	aspirations
tune	tunes
menace	menaces
repeat	repeats
bower	bowers
hypocrite	hypocrites
trump	trumps
hooligan	hooligans
communist	communists
result	results
front	fronts
cot	cots
executive	executives
environment	environments
storefront	storefronts
thong	thongs
parallel	parallels
bracelet	bracelets
church	churches
gypsy	gypsies
epidemic	epidemics
fin	fines
carpet	carpets
pancake	pancakes
laureate	laureates
item	items
backwater	backwaters
professional	professionals
bond	bonds
wing	wings
madman	madmen
bubble	bubbles
poster	posters
massacre	massacres
underestimate	underestimates
deposit	deposits
crevice	crevices
rehearsal	rehearsals
exec	execs
functionary	functionaries
vow	vows
component	components
punch	punches
soprano	sopranos
grouping	groupings
technician	technicians
sale	sales
underpass	underpasses
firm	firms
grinder	grinders
adolescent	adolescents
observation	observations
synagogue	synagogues
border	borders
sheikh	sheikhs
chainsaw	chainsaws
buyout	buyouts
imbalance	imbalances
exhibitor	exhibitors
roadway	roadways
compound	compounds
siren	sirens
heirloom	heirlooms
link	links
stagger	staggers
student	students
delegation	delegations
metaphor	metaphors
marcher	marchers
traditionalist	traditionalists
contradiction	contradictions
burglar	burglars
show	shows
keystroke	keystrokes
pallet	pallets
lure	lures
suicide	suicides
tortoise	tortoises
concert	concerts
vocalist	vocalists
paradox	paradoxes
flop	flops
spinner	spinners
review	reviews
chicken	chickens
final	finals
postcard	postcards
recession	recessions
bar	bars
pundit	pundits
clipping	clippings
forward	forwards
meter	meters
revolution	revolutions
listing	listings
stretch	stretches
offensive	offensives
mode	modes
high	highs
starlet	starlets
entertainer	entertainers
arsenal	arsenals
denominator	denominators
buffet	buffets
punishment	punishments
wash	washes
signpost	signposts
headache	headaches
specimen	specimens
boar	boars
decorator	decorators
physical	physicals
bout	bouts
sip	sips
superhero	superheroes
felony	felonies
beekeeper	beekeepers
crab	crabs
zine	zines
kid	kids
torrent	torrents
pig	pigs
point	points
mangrove	mangroves
default	defaults
beginning	beginnings
grill	grills
purpose	purposes
temp	temps
translation	translations
camper	campers
concourse	concourses
lip	lips
candle	candles
rung	rungs
host	hosts
lime	limes
collection	collections
mob	mobs
foursome	foursomes
tariff	tariffs
raincoat	raincoats
ailment	ailments
income	incomes
workload	workloads
rack	racks
developer	developers
frequency	frequencies
move	moves
dandelion	dandelions
deacon	deacons
gesture	gestures
cruiser	cruisers
insignia	insignias
deviation	deviations
infantryman	infantrymen
kitchen	kitchens
perch	perches
bid	bids
pin	pines
gap	gaps
squadron	squadrons
stroke	strokes
coach	coaches
bureau	bureaus
barnacle	barnacles
frontier	frontiers
rebound	rebounds
surplus	surpluses
mailing	mailings
multinational	multinationals
fortress	fortresses
grandparent	grandparents
testimonial	testimonials
idea	ideas
employee	employees
dame	dames
centrifuge	centrifuges
cathedral	cathedrals
pledge	pledges
prospector	prospectors
comrade	comrades
tower	towers
biography	biographies
holiday	holidays
franc	francs
thesis	theses
mate	mates
Tory	Tories
armadillo	armadillos
pacifist	pacifists
checkpoint	checkpoints
writ	writs
stimulant	stimulants
cattleman	cattlemen
forearm	forearms
strap	straps
frog	frogs
garland	garlands
refinery	refineries
reprise	reprises
conservationist	conservationists
stilt	stilts
concept	concepts
main	mains
photocopy	photocopies
indicator	indicators
screenwriter	screenwriters
home	homes
swimmer	swimmers
stereotype	stereotypes
cord	cords
laxative	laxatives
seance	seances
hinge	hinges
marshal	marshals
incision	incisions
recollection	recollections
gable	gables
buoy	buoys
simulation	simulations
valuation	valuations
volt	volts
dream	dreams
administrator	administrators
male	males
secretary	secretaries
vulture	vultures
merger	mergers
derivative	derivatives
dodger	dodgers
female	females
chalet	chalets
educator	educators
inflow	inflows
attic	attics
persona	personas
god	gods
miscarriage	miscarriages
extreme	extremes
polluter	polluters
arrow	arrows
talker	talkers
auction	auctions
fruit	fruits
symptom	symptoms
bear	bears
detective	detectives
cartoon	cartoons
hyena	hyenas
smuggler	smugglers
offer	offers
bastard	bastards
helm	helms
grandfather	grandfathers
portal	portals
animal	animals
dyke	dykes
appropriation	appropriations
campus	campuses
prairie	prairies
colleague	colleagues
promotion	promotions
helicopter	helicopters
profile	profiles
coupon	coupons
engine	engines
second	seconds
brat	brats
perpetrator	perpetrators
date	dates
library	libraries
parable	parables
talk	talks
hood	hoods
spin	spines
pastry	pastries
columnist	columnists
frame	frames
helper	helpers
federation	federations
mugger	muggers
billionaire	billionaires
treasury	treasuries
domain	domains
ideology	ideologies
sheet	sheets
extraction	extractions
wick	wicks
couple	couples
auctioneer	auctioneers
bathroom	bathrooms
remnant	remnants
page	pages
alto	altos
archivist	archivists
turnstile	turnstiles
thrust	thrusts
infrastructure	infrastructures
helmet	helmets
ward	wards
scenario	scenarios
emerald	emeralds
buckle	buckles
lineage	lineages
chimpanzee	chimpanzees
package	packages
speech	speeches
bender	benders
lira	lire
ballet	ballets
cop	copes
splinter	splinters
gather	gathers
pain	pains
hat	hats
pulsar	pulsars
appliance	appliances
revision	revisions
reeve	reeves
hoe	hoes
undertaking	undertakings
ring	rings
level	levels
commune	communes
speciality	specialities
spider	spiders
marshmallow	marshmallows
snake	snakes
jar	jars
overdraft	overdrafts
nomination	nominations
juror	jurors
injunction	injunctions
guise	guises
sardine	sardines
pageant	pageants
gym	gyms
coyote	coyotes
experiment	experiments
manuscript	manuscripts
seaport	seaports
axiom	axioms
address	addresses
minefield	minefields
spire	spires
force	forces
workshop	workshops
misconception	misconceptions
sim	sims
civilian	civilians
responsibility	responsibilities
weed	weeds
motorbike	motorbikes
plank	planks
couch	couches
satirist	satirists
payer	payers
landlord	landlords
millennium	millennia
eccentric	eccentrics
life	lifes
sedative	sedatives
drugstore	drugstores
forgery	forgeries
will	wills
exterior	exteriors
great	greats
draft	drafts
telecast	telecasts
chandelier	chandeliers
mite	mites
weakness	weaknesses
invalid	invalids
club	clubs
flurry	flurries
indie	indies
load	loads
tee	tees
hurdle	hurdles
tracker	trackers
sweatshirt	sweatshirts
ballot	ballots
lord	lords
memo	memos
showcase	showcases
penis	penises
motif	motifs
option	options
yam	yams
cod	codes
vintage	vintages
gymnast	gymnasts
infidelity	infidelities
meaning	meanings
testicle	testicles
amphetamine	amphetamines
wrap	wraps
partition	partitions
horseshoe	horseshoes
arrangement	arrangements
errand	errands
questionnaire	questionnaires
sketch	sketches
ballerina	ballerinas
job	jobs
scan	scans
proportion	proportions
tailor	tailors
solution	solutions
diver	divers
psychologist	psychologists
neanderthal	neanderthals
bow	bows
crowd	crowds
syndicate	syndicates
titan	titans
fly	flies
type	types
publicist	publicists
bun	buns
picnic	picnics
flat	flats
proposition	propositions
allotment	allotments
soldier	soldiers
dispute	disputes
token	tokens
bell	bells
condolence	condolences
gong	gongs
affair	affairs
politician	politicians
gust	gusts
dose	doses
companion	companions
pillow	pillows
throng	throngs
doctor	doctors
ghost	ghosts
blemish	blemishes
metal	metals
substation	substations
swamp	swamps
backup	backups
reprint	reprints
ox	oxen
putter	putters
machete	machetes
month	months
devil	devils
recreation	recreations
dresser	dressers
sacrament	sacraments
contingent	contingents
corral	corrales
ostrich	ostriches
view	views
intermediary	intermediaries
carrier	carriers
promise	promises
subscriber	subscribers
krone	kroner
performance	performances
fielder	fielders
stain	stains
spotlight	spotlights
prune	prunes
subsidiary	subsidiaries
boat	boats
medium	mediums
blooper	bloopers
culture	cultures
hue	hues
retiree	retirees
officer	officers
subway	subways
scuffle	scuffles
jerk	jerks
leaf	leaves
compass	compasses
announcer	announcers
community	communities
grad	grads
examination	examinations
typo	typos
reassurance	reassurances
summer	summers
glade	glades
rainstorm	rainstorms
ship	ships
six	sixes
parachute	parachutes
windmill	windmills
sheriff	sheriffs
embargo	embargoes
invitation	invitations
architect	architects
seminary	seminaries
navigator	navigators
crank	cranks
qualification	qualifications
snip	snipes
forum	forums
deformity	deformities
dodge	dodges
exemplar	exemplars
goalie	goalies
carrot	carrots
comeback	comebacks
elevator	elevators
creek	creeks
wire	wires
slot	slots
condo	condos
dormitory	dormitories
prankster	pranksters
tenet	tenets
shirt	shirts
lift	lifts
killer	killers
visa	visas
firefly	fireflies
grunt	grunts
lemur	lemurs
bon	bones
betrayal	betrayals
animator	animators
maverick	mavericks
planner	planners
dial	dials
visit	visits
barrier	barriers
journey	journeys
steer	steers
caregiver	caregivers
philosopher	philosophers
dispatch	dispatches
valley	valleys
violin	violins
confection	confections
ministry	ministries
tsunami	tsunamis
drug	drugs
purist	purists
fool	fools
earthquake	earthquakes
recount	recounts
collaborator	collaborators
rating	ratings
intimate	intimates
bailey	baileys
Bushman	Bushmen
trapper	trappers
thunderbolt	thunderbolts
doctrine	doctrines
physicist	physicists
notification	notifications
sweet	sweets
epic	epics
bladder	bladders
schism	schisms
crown	crowns
nova	novas
eyelid	eyelids
stick	sticks
skid	skids
rooftop	rooftops
poacher	poachers
touchdown	touchdowns
comma	commas
technologist	technologists
verb	verbs
slum	slums
subordinate	subordinates
priest	priests
ski	skies
tempo	tempos
ambassador	ambassadors
lamb	lambs
franchise	franchises
projector	projectors
hermit	hermits
rash	rashes
monkey	monkeys
soup	soups
petitioner	petitioners
waterway	waterways
dismissal	dismissals
beard	beards
blister	blisters
theory	theories
range	ranges
role	roles
acquittal	acquittals
strain	strains
friend	friends
apostle	apostles
graveyard	graveyards
grievance	grievances
packet	packets
bird	birds
vineyard	vineyards
idiot	idiots
workplace	workplaces
steal	steals
monarchy	monarchies
bill	bills
airman	airmen
commodore	commodores
footnote	footnotes
laurel	laurels
blackbird	blackbirds
period	periods
suburb	suburbs
hull	hulls
glory	glories
rifle	rifles
flow	flows
cab	cabs
shooting	shootings
soundtrack	soundtracks
scraper	scrapers
tile	tiles
sanctuary	sanctuaries
emission	emissions
bathtub	bathtubs
fixture	fixtures
square	squares
mussel	mussels
fleet	fleets
gram	grams
wrangler	wranglers
playboy	playboys
personality	personalities
bakery	bakeries
shuttle	shuttles
medicine	medicines
keg	kegs
cameraman	cameramen
bean	beans
belt	belts
snapshot	snapshots
tackle	tackles
ghoul	ghouls
gamer	gamers
majority	majorities
ass	asses
lighter	lighters
don	dons
vignette	vignettes
cameo	cameos
communicator	communicators
contingency	contingencies
interpreter	interpreters
spy	spies
tarantula	tarantulas
reward	rewards
pedal	pedals
company	companies
element	elements
reflection	reflections
assessment	assessments
aborigine	aborigines
alley	alleys
spear	spears
resume	resumes
poke	pokes
benefit	benefits
carving	carvings
peanut	peanuts
sprinkler	sprinklers
destroyer	destroyers
placement	placements
booklet	booklets
coaster	coasters
comb	combs
tracer	tracers
crony	cronies
last	lasts
server	servers
strut	struts
request	requests
elite	elites
plural	plurals
toe	toes
clinician	clinicians
tryout	tryouts
lama	lamas
smile	smiles
gatherer	gatherers
weevil	weevils
confidant	confidants
goal	goals
planetarium	planetariums
bull	bulls
social	socials
retirement	retirements
background	backgrounds
aroma	aromas
perennial	perennials
snag	snags
rendition	renditions
pedestrian	pedestrians
arrival	arrivals
ingredient	ingredients
country	countries
suspicion	suspicions
shop	shops
catastrophe	catastrophes
line	lines
player	players
Latino	Latinos
gate	gates
socialist	socialists
attacker	attackers
magician	magicians
alarm	alarms
carnival	carnivals
swap	swaps
atrocity	atrocities
replay	replays
barricade	barricades
muster	musters
charter	charters
gopher	gophers
inequality	inequalities
tread	treads
surveyor	surveyors
compulsion	compulsions
bed	beds
bolster	bolsters
aide	aides
festival	festivals
meteorite	meteorites
pipe	pipes
drawer	drawers
lament	laments
trafficker	traffickers
oyster	oysters
temper	tempers
sportswriter	sportswriters
tripper	trippers
holding	holdings
incidence	incidences
board	boards
courier	couriers
seaman	seamen
reader	readers
want	wants
mistake	mistakes
facade	facades
coon	coons
trend	trends
pivot	pivots
refusal	refusals
duty	duties
firecracker	firecrackers
network	networks
registry	registries
truss	trusses
electrician	electricians
coincidence	coincidences
tap	taps
landmine	landmines
year	years
hormone	hormones
chef	chefs
investigation	investigations
learner	learners
knob	knobs
outbreak	outbreaks
environmentalist	environmentalists
fairway	fairways
poet	poets
class	classes
minion	minions
tilt	tilts
author	authors
track	tracks
cigar	cigars
office	offices
opportunity	opportunities
pie	pies
laboratory	laboratories
meal	meals
spout	spouts
technique	techniques
floor	floors
bank	banks
briefcase	briefcases
photo	photos
swipe	swipes
pollster	pollsters
kilogram	kilograms
feeder	feeders
paradigm	paradigms
hipster	hipsters
rap	rapes
sacrifice	sacrifices
pellet	pellets
outcast	outcasts
kit	kits
grocer	grocers
ending	endings
interpretation	interpretations
tangerine	tangerines
sculptor	sculptors
plum	plumes
precondition	preconditions
megaton	megatons
reservoir	reservoirs
reason	reasons
milestone	milestones
gene	genes
queer	queers
caption	captions
pen	pens
abstract	abstracts
game	games
cargo	cargoes
chute	chutes
modification	modifications
tasting	tastings
topper	toppers
joker	jokers
balcony	balconies
obsession	obsessions
underling	underlings
weight	weights
miracle	miracles
king	kings
midfielder	midfielders
woodpecker	woodpeckers
decrease	decreases
patriot	patriots
gunshot	gunshots
cedar	cedars
watermelon	watermelons
solicitation	solicitations
blockade	blockades
pulpit	pulpits
drunk	drunks
calling	callings
gang	gangs
pharmacy	pharmacies
mine	mines
turban	turbans
cheek	cheeks
subpoena	subpoenas
assist	assists
fang	fangs
boardwalk	boardwalks
forester	foresters
vegan	vegans
trombone	trombones
bassist	bassists
orange	oranges
compact	compacts
infraction	infractions
broadcaster	broadcasters
prejudice	prejudices
inducement	inducements
folder	folders
lawman	lawmen
regulator	regulators
candidacy	candidacies
ventilator	ventilators
basket	baskets
saboteur	saboteurs
impulse	impulses
trustee	trustees
recording	recordings
burst	bursts
knife	knives
tactician	tacticians
heading	headings
object	objects
stint	stints
colony	colonies
roommate	roommates
ten	tens
character	characters
cheat	cheats
cone	cones
hank	hanks
diameter	diameters
railing	railings
turbine	turbines
source	sources
temperature	temperatures
reservist	reservists
sidewalk	sidewalks
contender	contenders
royal	royals
conversion	conversions
pronunciation	pronunciations
phone	phones
sidekick	sidekicks
way	ways
prong	prongs
sailboat	sailboats
accelerator	accelerators
quarry	quarries
judgment	judgments
trillion	trillions
importer	importers
caller	callers
hangover	hangovers
platter	platters
kilowatt	kilowatts
valentine	valentines
Chicano	Chicanos
frown	frowns
smash	smashes
door	doors
goon	goons
combination	combinations
stabilizer	stabilizers
follower	followers
historian	historians
log	logs
voter	voters
applicant	applicants
lemon	lemons
holder	holders
breakup	breakups
albatross	albatrosses
slump	slumps
wall	walls
ethic	ethics
heir	heirs
safe	safes
lily	lilies
orphanage	orphanages
doughnut	doughnuts
additive	additives
admiral	admirals
top	tops
microscope	microscopes
lifestyle	lifestyles
scrapbook	scrapbooks
murderer	murderers
armpit	armpits
deception	deceptions
congregation	congregations
register	registers
serpent	serpents
bride	brides
radish	radishes
rampart	ramparts
bone	bones
earring	earrings
hairstyle	hairstyles
thug	thugs
doorstep	doorsteps
brownie	brownies
essential	essentials
territory	territories
metro	metros
word	words
weekday	weekdays
value	values
depth	depths
compliment	compliments
malady	maladies
stipulation	stipulations
rig	rigs
fiesta	fiestas
haven	havens
baffle	baffles
oak	oaks
figure	figures
semi	semis
packer	packers
jack	jacks
potion	potions
antelope	antelopes
skyscraper	skyscrapers
lapse	lapses
chick	chicks
proxy	proxies
click	clicks
prerogative	prerogatives
curve	curves
bottom	bottoms
villa	villas
hop	hops
cousin	cousins
aside	asides
pasture	pastures
clique	cliques
mango	mangoes
mark	marks
silencer	silencers
infomercial	infomercials
dime	dimes
antigen	antigens
wig	wigs
ancestor	ancestors
radiator	radiators
transvestite	transvestites
smell	smells
disciple	disciples
injection	injections
payout	payouts
rib	ribs
drift	drifts
contention	contentions
shield	shields
briefing	briefings
title	titles
relay	relays
bulldozer	bulldozers
menu	menus
colt	colts
stirring	stirrings
stalk	stalks
primer	primers
racetrack	racetracks
skit	skits
hut	huts
leak	leaks
circuit	circuits
layman	laymen
novella	novellas
bomb	bombs
picket	pickets
champ	champs
roller	rollers
expedition	expeditions
prophecy	prophecies
enlargement	enlargements
fourth	fourths
carriage	carriages
gasket	gaskets
fork	forks
poplar	poplars
height	heights
freeway	freeways
trainer	trainers
daily	dailies
submarine	submarines
urinal	urinals
scream	screams
statement	statements
vapor	vapors
stigma	stigmas
posture	postures
prank	pranks
thumb	thumbs
subgroup	subgroups
foothill	foothills
kind	kinds
thermometer	thermometers
mare	mares
blossom	blossoms
shoe	shoes
etching	etchings
cart	carts
foundation	foundations
critter	critters
exclusive	exclusives
mixture	mixtures
noodle	noodles
cut	cuts
ranger	rangers
prop	props
fight	fights
residency	residencies
towel	towels
protagonist	protagonists
minivan	minivans
saint	saints
dimension	dimensions
park	parks
filling	fillings
third	thirds
sport	sports
incentive	incentives
port	ports
studio	studios
flame	flames
bible	bibles
stockpile	stockpiles
illusion	illusions
hardwood	hardwoods
hassle	hassles
collar	collars
tragedy	tragedies
bobcat	bobcats
subject	subjects
hike	hikes
vessel	vessels
bookie	bookies
dimple	dimples
accusation	accusations
craftsman	craftsmen
angel	angeles
grudge	grudges
explanation	explanations
butterfly	butterflies
sonata	sonatas
season	seasons
militia	militias
downturn	downturns
proton	protons
cuff	cuffs
bracket	brackets
recommendation	recommendations
swallow	swallows
plus	pluses
southerner	southerners
product	products
banquet	banquets
era	eras
minuteman	minutemen
porter	porters
ford	fords
daydream	daydreams
staple	staples
equation	equations
altitude	altitudes
digest	digests
tirade	tirades
iguana	iguanas
prostitute	prostitutes
van	vans
pull	pulls
impressionist	impressionists
share	shares
warning	warnings
biographer	biographers
victory	victories
weasel	weasels
marriage	marriages
hammer	hammers
snowman	snowmen
impostor	impostors
newt	newts
jacket	jackets
blower	blowers
toxin	toxins
fragrance	fragrances
ally	allies
blip	blips
tract	tracts
desire	desires
miller	millers
occupier	occupiers
deity	deities
merchant	merchants
toothbrush	toothbrushes
lodge	lodges
eulogy	eulogies
ember	embers
resemblance	resemblances
sierra	sierras
manufacturer	manufacturers
lag	lags
greenback	greenbacks
increment	increments
dollar	dollars
toad	toads
emigrant	emigrants
upstart	upstarts
recess	recesses
mesa	mesas
aria	arias
pun	puns
superintendent	superintendents
fluctuation	fluctuations
cubicle	cubicles
viewer	viewers
proprietor	proprietors
barrio	barrios
evening	evenings
troupe	troupes
gale	gales
antiquity	antiquities
dragon	dragons
guarantee	guarantees
contribution	contributions
gentleman	gentlemen
allowance	allowances
cheese	cheeses
smack	smacks
pathogen	pathogens
draw	draws
pager	pagers
baseline	baselines
stance	stances
coronation	coronations
strip	strips
spike	spikes
fungus	fungi
turret	turrets
program	programs
sandwich	sandwiches
snowfall	snowfalls
battle	battles
insurgent	insurgents
inference	inferences
squire	squires
shank	shanks
genre	genres
fir	firs
divorce	divorces
piglet	piglets
imperative	imperatives
statuette	statuettes
catheter	catheters
horde	hordes
critic	critics
bluff	bluffs
clone	clones
impediment	impediments
dinar	dinars
mosquito	mosquitoes
driver	drivers
moat	moats
rival	rivals
twig	twigs
touch	touches
skeptic	skeptics
gladiator	gladiators
dove	doves
operator	operators
song	songs
ecosystem	ecosystems
angel	angels
revival	revivals
bookmaker	bookmakers
starter	starters
memorandum	memorandums
likeness	likenesses
cadaver	cadavers
characteristic	characteristics
wheelchair	wheelchairs
contaminant	contaminants
fifth	fifths
smoothie	smoothies
hemorrhage	hemorrhages
wiper	wipers
hind	hinds
carbohydrate	carbohydrates
team	teams
edge	edges
stare	stares
trailblazer	trailblazers
parish	parishes
pension	pensions
laggard	laggards
screw	screws
raft	rafts
flank	flanks
preview	previews
umpire	umpires
heap	heaps
waffle	waffles
assembly	assemblies
expatriate	expatriates
guideline	guidelines
let	lets
wrist	wrists
hacker	hackers
byte	bytes
emirate	emirates
cylinder	cylinders
that	those
special	specials
drive	drives
certification	certifications
necessity	necessities
stripper	strippers
headstone	headstones
emperor	emperors
arrowhead	arrowheads
winery	wineries
pine	pines
convention	conventions
thoroughbred	thoroughbreds
establishment	establishments
magnet	magnets
airway	airways
tourist	tourists
economy	economies
blouse	blouses
fireman	firemen
cornea	corneas
anomaly	anomalies
ability	abilities
kilt	kilts
mover	movers
stringer	stringers
copier	copiers
slipper	slippers
pickle	pickles
lens	lenses
silo	silos
henchman	henchmen
rascal	rascals
contributor	contributors
documentary	documentaries
spud	spuds
scratch	scratches
battery	batteries
caddy	caddies
expansion	expansions
porthole	portholes
escalator	escalators
wink	winks
puck	pucks
erection	erections
entrance	entrances
cap	caps
gift	gifts
pole	poles
family	families
right	rights
bra	bras
waltz	waltzes
composition	compositions
blade	blades
blur	blurs
midshipman	midshipmen
hoard	hoards
glue	glues
ambulance	ambulances
cadence	cadences
oven	ovens
boiler	boilers
membrane	membranes
stream	streams
tomahawk	tomahawks
mat	mats
copyright	copyrights
conception	conceptions
skip	skips
herd	herds
radical	radicals
empire	empires
coconut	coconuts
trip	trips
martin	martins
warship	warships
provocation	provocations
demon	demons
senator	senators
clip	clips
cliffhanger	cliffhangers
connotation	connotations
classroom	classrooms
knee	knees
hole	holes
tan	tans
outhouse	outhouses
echelon	echelons
disinfectant	disinfectants
habit	habits
parliamentarian	parliamentarians
ceremony	ceremonies
stomach	stomachs
obstruction	obstructions
flyer	flyers
horoscope	horoscopes
coat	coats
diaphragm	diaphragms
pas	pass
zipper	zippers
weekly	weeklies
mirror	mirrors
reflex	reflexes
adherent	adherents
auto	autos
chime	chimes
suck	sucks
beaver	beavers
riddle	riddles
trench	trenches
stern	sterns
dressing	dressings
fist	fists
lad	lads
accent	accents
purveyor	purveyors
serve	serves
profession	professions
totem	totems
effigy	effigies
motorboat	motorboats
maid	maids
alternative	alternatives
spill	spills
textile	textiles
stockholder	stockholders
conscience	consciences
alliance	alliances
spell	spells
folly	follies
cast	casts
foray	forays
unit	units
fad	fades
console	consoles
shaman	shamans
commandment	commandments
destiny	destinies
filly	fillies
bye	byes
dish	dishes
steward	stewards
absence	absences
change	changes
pink	pinks
knoll	knolls
retailer	retailers
measure	measures
notation	notations
puzzle	puzzles
gunslinger	gunslingers
farmer	farmers
claimant	claimants
commercial	commercials
forecast	forecasts
pit	pits
robbery	robberies
delusion	delusions
novel	novels
moon	moons
wrongdoing	wrongdoings
gaff	gaffes
difference	differences
waist	waists
generator	generators
bayou	bayous
peach	peaches
maple	maples
emergency	emergencies
herb	herbs
rhythm	rhythms
newsman	newsmen
bus	buses
leg	legs
marker	markers
hostel	hostels
makeover	makeovers
spotter	spotters
pardon	pardons
cookbook	cookbooks
scar	scars
treatment	treatments
kitten	kittens
bodyguard	bodyguards
charlatan	charlatans
demerit	demerits
reception	receptions
box	boxes
homeowner	homeowners
olive	olives
ogre	ogres
accordion	accordions
cereal	cereals
hybrid	hybrids
practitioner	practitioners
fiddle	fiddles
scorer	scorers
stack	stacks
cracker	crackers
theorist	theorists
dupe	dupes
goodie	goodies
tack	tacks
raider	raiders
gel	gels
allergen	allergens
notebook	notebooks
cicada	cicadas
body	bodies
ego	egos
reunion	reunions
mast	masts
tangle	tangles
sparrow	sparrows
colliery	collieries
search	searches
float	floats
cupboard	cupboards
discovery	discoveries
tombstone	tombstones
filament	filaments
lesion	lesions
pigeon	pigeons
streamer	streamers
adoption	adoptions
overall	overalls
microprocessor	microprocessors
dealer	dealers
bug	bugs
album	albums
privatization	privatizations
cube	cubes
tale	tales
go	goes
vocal	vocals
crew	crews
gospel	gospels
speck	specks
kindergarten	kindergartens
jaw	jaws
famine	famines
flick	flicks
barn	barns
skirt	skirts
instrumentalist	instrumentalists
selector	selectors
storyteller	storytellers
finding	findings
zombie	zombies
skinhead	skinheads
union	unions
excuse	excuses
future	futures
compressor	compressors
direction	directions
batsman	batsmen
apology	apologies
friar	friars
resource	resources
forge	forges
protector	protectors
amendment	amendments
mile	miles
insurer	insurers
major	majors
wholesaler	wholesalers
make	makes
stable	stables
malfunction	malfunctions
freshman	freshmen
variation	variations
meeting	meetings
autopsy	autopsies
hymn	hymns
rule	rules
gully	gullies
vine	vines
queue	queues
brawl	brawls
curfew	curfews
taste	tastes
interloper	interlopers
remainder	remainders
blank	blanks
virus	viruses
heavyweight	heavyweights
vigil	vigils
decision	decisions
ankle	ankles
bath	baths
stocking	stockings
correction	corrections
tail	tails
actor	actors
climber	climbers
core	cores
puff	puffs
primary	primaries
debut	debuts
deal	deals
strongman	strongmen
inequity	inequities
weatherman	weathermen
pedigree	pedigrees
dairy	dairies
grade	grades
overrun	overruns
volcano	volcanoes
courtroom	courtrooms
militiaman	militiamen
workout	workouts
contour	contours
childhood	childhoods
mishap	mishaps
procedure	procedures
priority	priorities
stairway	stairways
brigade	brigades
loudspeaker	loudspeakers
history	histories
tube	tubes
interior	interiors
fireball	fireballs
withdrawal	withdrawals
shoulder	shoulders
incumbent	incumbents
diplomat	diplomats
pygmy	pygmies
see	sees
discussion	discussions
inquisition	inquisitions
flashpoint	flashpoints
trademark	trademarks
exhibition	exhibitions
marksman	marksmen
airdrop	airdrops
brute	brutes
specialty	specialities
cue	cues
mountain	mountains
wannabe	wannabes
diploma	diplomas
destination	destinations
sequel	sequels
debt	debts
timberland	timberlands
parliament	parliaments
showroom	showrooms
miniature	miniatures
reactionary	reactionaries
slaughterhouse	slaughterhouses
actuary	actuaries
mechanism	mechanisms
adaptation	adaptations
princess	princesses
workstation	workstations
pat	pats
dive	dives
trainee	trainees
collect	collects
alias	aliases
commando	commandos
mug	mugs
application	applications
harness	harnesses
wish	wishes
substitution	substitutions
degenerate	degenerates
savage	savages
axle	axles
midwife	midwives
scorpion	scorpions
consultant	consultants
sink	sinks
joint	joints
deliberation	deliberations
drawback	drawbacks
loss	losses
botanist	botanists
goalkeeper	goalkeepers
rogue	rogues
settlement	settlements
au	aus
baron	barons
apron	aprons
collage	collages
weapon	weapons
broadside	broadsides
rupee	rupees
hunt	hunts
saying	sayings
curb	curbs
levy	levies
blaze	blazes
aim	aims
pad	pads
estimate	estimates
barometer	barometers
terrier	terriers
heavy	heavies
critique	critiques
furnace	furnaces
courthouse	courthouses
recrimination	recriminations
caveman	cavemen
vial	vials
hamlet	hamlets
ranking	rankings
rodeo	rodeos
ferry	ferries
policy	policies
skeleton	skeletons
failing	failings
cliff	cliffs
jolt	jolts
trumpet	trumpets
limit	limits
exemption	exemptions
pastel	pastels
file	files
opportunist	opportunists
overpass	overpasses
speaker	speakers
preschool	preschools
guest	guests
buyer	buyers
bidder	bidders
stage	stages
shipwreck	shipwrecks
vector	vectors
tumble	tumbles
guy	guys
ramp	ramps
hilt	hilts
undercurrent	undercurrents
clock	clocks
naturalist	naturalists
pot	pots
transsexual	transsexuals
hug	hugs
attorney	attorneys
transporter	transporters
torture	tortures
ribbon	ribbons
steamboat	steamboats
avenue	avenues
temple	temples
pose	poses
ornament	ornaments
tattoo	tattoos
sweater	sweaters
interface	interfaces
oar	oars
adventurer	adventurers
variable	variables
vendetta	vendettas
cycle	cycles
equal	equals
captor	captors
parameter	parameters
idol	idols
hobby	hobbies
sensitivity	sensitivities
pronouncement	pronouncements
disco	discos
model	models
mortal	mortals
correlation	correlations
alderman	aldermen
shantytown	shantytowns
precaution	precautions
bass	basses
comedy	comedies
motive	motives
inductee	inductees
editor	editors
video	videos
download	downloads
winner	winners
quad	quads
statesman	statesmen
felon	felons
grandchild	grandchildren
draftee	draftees
ploy	ploys
implant	implants
mailer	mailers
week	weeks
disaster	disasters
bulb	bulbs
loyalist	loyalists
visitation	visitations
eye	eyes
sleeve	sleeves
catalyst	catalysts
sapling	saplings
press	presses
cabin	cabins
particle	particles
plan	plans
projection	projections
still	stills
capability	capabilities
mailbox	mailboxes
overseer	overseers
take	takes
reminiscence	reminiscences
birth	births
necklace	necklaces
casino	casinos
opening	openings
landslide	landslides
wavelength	wavelengths
section	sections
sideline	sidelines
maniac	maniacs
international	internationals
spook	spooks
thrill	thrills
intruder	intruders
saucer	saucers
quarterback	quarterbacks
anchor	anchors
proceeding	proceedings
synod	synods
tenement	tenements
seizure	seizures
patch	patches
edict	edicts
carol	carols
capital	capitals
wombat	wombats
clearing	clearings
butler	butlers
doubt	doubts
hippie	hippies
kiosk	kiosks
decimal	decimals
doorway	doorways
project	projects
permit	permits
hen	hens
tiger	tigers
appraisal	appraisals
facilitator	facilitators
illness	illnesses
babe	babes
nap	naps
frigate	frigates
degree	degrees
shipper	shippers
feeling	feelings
ant	ants
narcotic	narcotics
neuron	neurons
grower	growers
avocado	avocados
declaration	declarations
shiver	shivers
spur	spurs
neck	necks
cape	capes
denomination	denominations
formality	formalities
lighthouse	lighthouses
chaperone	chaperones
tether	tethers
crow	crows
echo	echoes
rest	rests
soap	soaps
janitor	janitors
innocent	innocents
surgeon	surgeons
camel	camels
guardian	guardians
cheerleader	cheerleaders
splint	splints
pang	pangs
casing	casings
bus	buss
robber	robbers
wart	warts
hardliner	hardliners
cyclist	cyclists
superstore	superstores
upset	upsets
stride	strides
searchlight	searchlights
translator	translators
connector	connectors
case	cases
frustration	frustrations
goer	goers
millionaire	millionaires
general	generals
area	areas
hilltop	hilltops
lawyer	lawyers
daisy	daisies
dignitary	dignitaries
noun	nouns
scanner	scanners
advance	advances
blockbuster	blockbusters
living	livings
airbag	airbags
builder	builders
acre	acres
gross	grosses
roadblock	roadblocks
plaque	plaques
announcement	announcements
hideout	hideouts
dissident	dissidents
donation	donations
recipe	recipes
underdog	underdogs
plane	planes
detergent	detergents
stud	studs
sub	subs
brave	braves
breaker	breakers
automobile	automobiles
lid	lids
shudder	shudders
koala	koalas
bungalow	bungalows
carton	cartons
airfield	airfields
definition	definitions
baby	babies
boyfriend	boyfriends
entrant	entrants
creature	creatures
lease	leases
fern	ferns
stooge	stooges
zebra	zebras
outflow	outflows
manifesto	manifestos
microphone	microphones
lubricant	lubricants
brace	braces
context	contexts
leaning	leanings
converter	converters
northerner	northerners
bailiff	bailiffs
pea	peas
trolley	trolleys
napkin	napkins
chieftain	chieftains
youth	youths
protein	proteins
fracture	fractures
exam	exams
fault	faults
answer	answers
actress	actresses
latitude	latitudes
segment	segments
rip	rips
groom	grooms
nod	nodes
penguin	penguins
antibiotic	antibiotics
strikeout	strikeouts
warlord	warlords
constraint	constraints
breast	breasts
scene	scenes
harbinger	harbingers
audition	auditions
pesticide	pesticides
cluster	clusters
addict	addicts
lane	lanes
gear	gears
criticism	criticisms
sinus	sinuses
comet	comets
denial	denials
torch	torches
hazard	hazards
legend	legends
category	categories
attitude	attitudes
accomplishment	accomplishments
engagement	engagements
icon	icons
warrant	warrants
password	passwords
championship	championships
tip	tips
fair	fairs
handful	handfuls
waterfall	waterfalls
mention	mentions
pensioner	pensioners
table	tables
showman	showmen
hog	hogs
panel	panels
posting	postings
anthology	anthologies
cymbal	cymbals
arch	arches
proposal	proposals
loan	loans
haunt	haunts
monolith	monoliths
sultan	sultans
onlooker	onlookers
longhorn	longhorns
acrobat	acrobats
principle	principles
sill	sills
sling	slings
precinct	precincts
imam	imams
dilemma	dilemmas
negotiator	negotiators
criterion	criteria
tradition	traditions
pattern	patterns
airline	airlines
sovereign	sovereigns
twin	twins
hijacking	hijackings
inn	inns
sunflower	sunflowers
shave	shaves
boy	boys
shooter	shooters
legacy	legacies
fiddler	fiddlers
truck	trucks
truce	truces
booby	boobies
prosecution	prosecutions
staircase	staircases
drink	drinks
astronaut	astronauts
chance	chances
steak	steaks
phantom	phantoms
plant	plants
ticket	tickets
peasant	peasants
perspective	perspectives
artisan	artisans
pool	pools
conclusion	conclusions
matter	matters
medication	medications
ocean	oceans
rear	rears
celebration	celebrations
wafer	wafers
prior	priors
report	reports
riser	risers
framework	frameworks
emblem	emblems
alert	alerts
shin	shins
tropic	tropics
ordeal	ordeals
digger	diggers
organization	organizations
wood	woods
node	nodes
interaction	interactions
windshield	windshields
hitch	hitches
barrow	barrows
guild	guilds
reporter	reporters
reality	realities
round	rounds
tanker	tankers
heater	heaters
doe	does
landowner	landowners
bluebird	bluebirds
cripple	cripples
borough	boroughs
reprisal	reprisals
brown	browns
hangar	hangars
lagoon	lagoons
bruise	bruises
intervention	interventions
florist	florists
update	updates
progressive	progressives
plain	plains
solid	solids
convict	convicts
baker	bakers
outlaw	outlaws
ravine	ravines
bin	bins
minority	minorities
bronco	broncos
librarian	librarians
penalty	penalties
bogey	bogeys
mogul	moguls
victim	victims
supplement	supplements
referendum	referenda
cinder	cinders
terrorist	terrorists
strawberry	strawberries
inhibition	inhibitions
tributary	tributaries
mistress	mistresses
yell	yells
salesman	salesmen
gas	gass
suggestion	suggestions
immigrant	immigrants
shoreline	shorelines
reject	rejects
radar	radars
bounty	bounties
carver	carvers
countryman	countrymen
shack	shacks
cushion	cushions
theologian	theologians
wingtip	wingtips
pin	pins
decoy	decoys
person	people
licensee	licensees
breakdown	breakdowns
rocker	rockers
salvo	salvos
saga	sagas
scallop	scallops
substitute	substitutes
myth	myths
mike	mikes
jewel	jewels
howl	howls
spender	spenders
rotor	rotors
predictor	predictors
chew	chews
presenter	presenters
defendant	defendants
villain	villains
cook	cooks
joke	jokes
refrain	refrains
snowball	snowballs
craving	cravings
platform	platforms
prosecutor	prosecutors
batch	batches
peep	peeps
novelty	novelties
station	stations
venue	venues
combatant	combatants
newsreel	newsreels
delivery	deliveries
bulletin	bulletins
gateway	gateways
disc	discs
common	commons
gown	gowns
nanny	nannies
coward	cowards
philosophy	philosophies
reversal	reversals
loom	looms
inspector	inspectors
remedy	remedies
chin	chins
basement	basements
allegation	allegations
bully	bullies
juggler	jugglers
bonnet	bonnets
tray	trays
spoof	spoofs
snail	snails
monster	monsters
liberal	liberals
snowflake	snowflakes
quota	quotas
radiologist	radiologists
exporter	exporters
shed	sheds
headlight	headlights
aquarium	aquariums
room	rooms
pawn	pawns
forest	forests
tub	tubs
antidepressant	antidepressants
rapist	rapists
cancellation	cancellations
fate	fates
flea	fleas
microchip	microchips
day	days
turtle	turtles
summit	summits
mac	macs
formula	formulas
gill	gilles
rebellion	rebellions
breech	breeches
lieutenant	lieutenants
amplifier	amplifiers
appetite	appetites
democracy	democracies
pub	pubs
dip	dips
syndrome	syndromes
ad	ads
cleaner	cleaners
drinker	drinkers
population	populations
negative	negatives
hostess	hostesses
newspaper	newspapers
foreman	foremen
canton	cantons
pronoun	pronouns
current	currents
unknown	unknowns
fold	folds
battleship	battleships
hatchery	hatcheries
clutch	clutches
serenade	serenades
pheasant	pheasants
queen	queens
turkey	turkeys
construct	constructs
cow	cows
ham	hams
entertainment	entertainments
machinist	machinists
funnel	funnels
surface	surfaces
taker	takers
nick	nicks
pocket	pockets
spoiler	spoilers
campfire	campfires
sleeper	sleepers
cowboy	cowboys
barbarian	barbarians
gatekeeper	gatekeepers
scholarship	scholarships
rose	roses
carat	carats
stimulus	stimuli
visitor	visitors
interviewee	interviewees
worker	workers
flute	flutes
tomato	tomatoes
hotel	hotels
chap	chaps
thermostat	thermostats
compilation	compilations
affidavit	affidavits
chunk	chunks
rope	ropes
giraffe	giraffes
complainant	complainants
stool	stools
gunship	gunships
gyroscope	gyroscopes
fuel	fuels
souvenir	souvenirs
bunch	bunches
double	doubles
junior	juniors
arranger	arrangers
crossing	crossings
bayonet	bayonets
interview	interviews
website	websites
transplant	transplants
cynic	cynics
cyclone	cyclones
brother	brothers
heartbeat	heartbeats
frill	frills
acquaintance	acquaintances
regular	regulars
violinist	violinists
passageway	passageways
routine	routines
set	sets
split	splits
electron	electrons
principal	principals
boss	bosses
teller	tellers
auxiliary	auxiliaries
ghetto	ghettos
raffle	raffles
pup	pups
criminal	criminals
academy	academies
tendency	tendencies
substance	substances
aristocrat	aristocrats
face	faces
automatic	automatics
dispenser	dispensers
blueprint	blueprints
supervisor	supervisors
roast	roasts
decibel	decibels
insider	insiders
puppeteer	puppeteers
outburst	outbursts
propellant	propellants
gain	gains
distance	distances
statue	statues
preacher	preachers
screening	screenings
instinct	instincts
act	acts
prospect	prospects
opiate	opiates
error	errors
retainer	retainers
diamond	diamonds
eccentricity	eccentricities
nursery	nurseries
assertion	assertions
outlay	outlays
headliner	headliners
ambush	ambushes
recital	recitals
council	councils
recipient	recipients
nationality	nationalities
accountant	accountants
skate	skates
reform	reforms
standard	standards
jockey	jockeys
inspiration	inspirations
aspect	aspects
regent	regents
elk	elks
peacemaker	peacemakers
preference	preferences
planter	planters
conversation	conversations
mother	mothers
assortment	assortments
strategist	strategists
thread	threads
mood	moods
combine	combines
incarnation	incarnations
misfit	misfits
bunker	bunkers
salary	salaries
speedboat	speedboats
switchboard	switchboards
wife	wives
suitcase	suitcases
assault	assaults
arena	arenas
fail	fails
thinker	thinkers
misunderstanding	misunderstandings
revolt	revolts
threat	threats
roll	rolls
wrench	wrenches
patty	patties
intersection	intersections
stop	stops
spaceship	spaceships
extension	extensions
depressant	depressants
athlete	athletes
wake	wakes
editorial	editorials
shutdown	shutdowns
quarrel	quarrels
grenade	grenades
psychoanalyst	psychoanalysts
possibility	possibilities
granddaughter	granddaughters
bundle	bundles
peel	peels
remake	remakes
allegiance	allegiances
villager	villagers
flashlight	flashlights
fraud	frauds
hot	hots
confederation	confederations
stress	stresses
constellation	constellations
crumb	crumbs
desert	deserts
broadcast	broadcasts
kiln	kilns
shingle	shingles
earthworm	earthworms
virtuoso	virtuosos
fear	fears
newcomer	newcomers
otter	otters
brewer	brewers
orchard	orchards
profanity	profanities
buck	bucks
crash	crashes
mutation	mutations
issue	issues
brew	brews
plateau	plateaus
cobra	cobras
romantic	romantics
berry	berries
hospice	hospices
bark	barks
method	methods
broker	brokers
marina	marinas
injury	injuries
supermarket	supermarkets
village	villages
elephant	elephants
exit	exits
collaboration	collaborations
nugget	nuggets
diagram	diagrams
anniversary	anniversaries
pouch	pouches
reptile	reptiles
monsoon	monsoons
average	averages
perimeter	perimeters
insurgency	insurgencies
order	orders
rebate	rebates
stinger	stingers
forerunner	forerunners
crusade	crusades
aggressor	aggressors
stall	stalls
economist	economists
apparition	apparitions
message	messages
clog	clogs
warren	warrens
blonde	blondes
strike	strikes
insert	inserts
whisper	whispers
assailant	assailants
bitch	bitches
tornado	tornados
magnolia	magnolias
climb	climbs
mimic	mimics
inn	innes
regiment	regiments
broom	brooms
captive	captives
borrowing	borrowings
yourself	yourselves
prototype	prototypes
shrub	shrubs
locale	locales
uprising	uprisings
journalist	journalists
oppressor	oppressors
dividend	dividends
incubator	incubators
monk	monks
handout	handouts
firework	fireworks
frank	franks
melon	melons
calculation	calculations
refinement	refinements
original	originals
occupant	occupants
quirk	quirks
extra	extras
intention	intentions
stockbroker	stockbrokers
citation	citations
upheaval	upheavals
syllable	syllables
self	selves
sponge	sponges
loo	loos
spark	sparks
lake	lakes
dictatorship	dictatorships
blind	blinds
poll	polls
alloy	alloys
dent	dents
craft	crafts
storeroom	storerooms
hill	hills
skirmish	skirmishes
scholar	scholars
pupil	pupils
eagle	eagles
corset	corsets
sari	saris
fantasy	fantasies
bomber	bombers
food	foods
doll	dolls
culprit	culprits
sportsman	sportsmen
language	languages
evil	evils
launcher	launchers
portrait	portraits
cardinal	cardinals
fan	fans
regimen	regimens
cloud	clouds
fund	funds
classmate	classmates
robin	robins
pilgrim	pilgrims
mannequin	mannequins
owner	owners
creole	creoles
frogman	frogmen
occupation	occupations
runaway	runaways
jam	jams
premium	premiums
mineral	minerals
wrinkle	wrinkles
krona	kronor
avalanche	avalanches
shortcoming	shortcomings
triumph	triumphs
passion	passions
tongue	tongues
angler	anglers
glitch	glitches
writ	writes
rookie	rookies
coin	coins
material	materials
slacker	slackers
consequence	consequences
squeeze	squeezes
feast	feasts
shore	shores
projectile	projectiles
salad	salads
Paddy	Paddies
watch	watches
nun	nuns
tablet	tablets
painkiller	painkillers
chaser	chasers
supply	supplies
shape	shapes
jetty	jetties
fugitive	fugitives
herbicide	herbicides
troll	trolls
shareholder	shareholders
expression	expressions
banjo	banjos
idiom	idioms
sum	sums
plume	plumes
cottage	cottages
musician	musicians
opponent	opponents
fetish	fetishes
mural	murals
secret	secrets
sponsor	sponsors
preliminary	preliminaries
sergeant	sergeants
preserve	preserves
course	courses
cause	causes
weaver	weavers
shadow	shadows
plaintiff	plaintiffs
mime	mimes
nuance	nuances
hotline	hotlines
traitor	traitors
secessionist	secessionists
conservative	conservatives
dick	dicks
first	firsts
stakeholder	stakeholders
official	officials
inclination	inclinations
hatred	hatreds
raid	raids
venture	ventures
pennant	pennants
dress	dresses
airport	airports
discus	discuss
crypt	crypts
shopkeeper	shopkeepers
newsletter	newsletters
problem	problems
do	dos
lender	lenders
awakening	awakenings
trawler	trawlers
commuter	commuters
idealist	idealists
discotheque	discotheques
acronym	acronyms
torso	torsos
premier	premiers
dog	dogs
cosmonaut	cosmonauts
prisoner	prisoners
subculture	subcultures
privilege	privileges
coop	coops
auditor	auditors
shard	shards
lifetime	lifetimes
catalogue	catalogues
yield	yields
messenger	messengers
pile	piles
guru	gurus
chop	chops
shrug	shrugs
refrigerator	refrigerators
lecturer	lecturers
seed	seeds
tome	tomes
preservative	preservatives
style	styles
collier	colliers
daddy	daddies
pact	pacts
encampment	encampments
society	societies
cascade	cascades
summary	summaries
annuity	annuities
restriction	restrictions
butt	butts
outlook	outlooks
humorist	humorists
wedding	weddings
fertilizer	fertilizers
climate	climates
runner	runners
psychic	psychics
medal	medals
slowdown	slowdowns
agnostic	agnostics
atmosphere	atmospheres
shotgun	shotguns
relationship	relationships
glider	gliders
drain	drains
conspirator	conspirators
bulldog	bulldogs
affiliate	affiliates
spoon	spoons
seller	sellers
mentor	mentors
rattlesnake	rattlesnakes
proverb	proverbs
gem	gems
variety	varieties
war	wars
aqueduct	aqueducts
confusion	confusions
millisecond	milliseconds
refill	refills
cranberry	cranberries
snippet	snippets
virgin	virgins
appendage	appendages
municipality	municipalities
lotion	lotions
alcoholic	alcoholics
congressman	congressmen
gymnasium	gymnasiums
industrialist	industrialists
nod	nods
enzyme	enzymes
polish	polishes
demonstrator	demonstrators
quality	qualities
passport	passports
graduate	graduates
mushroom	mushrooms
optimist	optimists
dinosaur	dinosaurs
inventor	inventors
meadow	meadows
conviction	convictions
phobia	phobias
factor	factors
underwriter	underwriters
horse	horses
mammal	mammals
slicker	slickers
internship	internships
debate	debates
garage	garages
warden	wardens
patient	patients
jumper	jumpers
kangaroo	kangaroos
laugh	laughs
premiere	premieres
beach	beaches
slick	slicks
bum	bums
contemporary	contemporaries
headband	headbands
grant	grants
mosque	mosques
pineapple	pineapples
envelope	envelopes
innkeeper	innkeepers
mandate	mandates
reflector	reflectors
cold	colds
steelworker	steelworkers
foundry	foundries
pistol	pistols
sample	samples
infidel	infidels
blunder	blunders
instability	instabilities
creator	creators
gardener	gardeners
handicap	handicaps
transient	transients
topping	toppings
ream	reams
procession	processions
rut	ruts
slam	slams
size	sizes
handbag	handbags
hollow	hollows
compatriot	compatriots
lobe	lobes
mainframe	mainframes
challenge	challenges
lunatic	lunatics
marvel	marvels
tester	testers
reservation	reservations
pan	panes
breakfast	breakfasts
skewer	skewers
century	centuries
photograph	photographs
temptation	temptations
taxpayer	taxpayers
snout	snouts
celebrity	celebrities
vehicle	vehicles
paramedic	paramedics
shred	shreds
hamster	hamsters
nipple	nipples
lizard	lizards
teaser	teasers
precept	precepts
serviceman	servicemen
amphibian	amphibians
sweetheart	sweethearts
rollover	rollovers
slave	slaves
trough	troughs
tire	tires
departure	departures
mattress	mattresses
spouse	spouses
sweatshop	sweatshops
impairment	impairments
ban	bans
realm	realms
nettle	nettles
league	leagues
tribunal	tribunals
footballer	footballers
beater	beaters
moment	moments
eyebrow	eyebrows
counter	counters
pier	piers
banker	bankers
producer	producers
uncertainty	uncertainties
notch	notches
fringe	fringes
liquidation	liquidations
clinic	clinics
waiver	waivers
voucher	vouchers
fighter	fighters
expanse	expanses
movement	movements
sailor	sailors
policymaker	policymakers
candy	candies
mouth	mouths
scoop	scoops
heathen	heathens
entity	entities
choke	chokes
stub	stubs
layer	layers
worm	worms
grab	grabs
building	buildings
freeze	freezes
exception	exceptions
failure	failures
signature	signatures
replica	replicas
wag	wags
concentrate	concentrates
sofa	sofas
shroud	shrouds
tycoon	tycoons
misfortune	misfortunes
rat	rats
geyser	geysers
greyhound	greyhounds
duo	duos
piece	pieces
save	saves
outpatient	outpatients
blob	blobs
promoter	promoters
arm	arms
disclaimer	disclaimers
prison	prisons
subplot	subplots
store	stores
bot	bots
cello	cellos
massage	massages
tomcat	tomcats
wag	wages
jailer	jailers
charm	charms
hallway	hallways
emotion	emotions
authority	authorities
sportscaster	sportscasters
base	bases
staff	staffs
parasite	parasites
dean	deans
bowl	bowls
forecaster	forecasters
gland	glands
township	townships
fish	fishes
bite	bites
blend	blends
lineman	linemen
convoy	convoys
fungicide	fungicides
censor	censors
prom	proms
hoodlum	hoodlums
artifact	artifacts
rabbi	rabbis
nominee	nominees
assurance	assurances
condemnation	condemnations
hedge	hedges
galaxy	galaxies
position	positions
lab	labs
duplicate	duplicates
pagan	pagans
negotiation	negotiations
bunk	bunks
persona	personae
stronghold	strongholds
opposite	opposites
guitarist	guitarists
cipher	ciphers
display	displays
angle	angles
chip	chips
striker	strikers
lobby	lobbies
certainty	certainties
hyphen	hyphens
beneficiary	beneficiaries
intrigue	intrigues
treaty	treaties
fell	fells
endowment	endowments
mixer	mixers
bicycle	bicycles
showing	showings
petal	petals
hamper	hampers
blizzard	blizzards
argument	arguments
reign	reigns
branch	branches
sneaker	sneakers
slug	slugs
pilgrimage	pilgrimages
descendant	descendants
scorecard	scorecards
elf	elves
gimmick	gimmicks
rag	rags
cutback	cutbacks
leadership	leaderships
wanderer	wanderers
porpoise	porpoises
suitor	suitors
loon	loons
claim	claims
burglary	burglaries
carter	carters
fingerprint	fingerprints
utterance	utterances
cardiologist	cardiologists
transformation	transformations
decree	decrees
session	sessions
lentil	lentils
railway	railways
downpour	downpours
cucumber	cucumbers
gal	gals
band	bands
rev	revs
moor	moors
decade	decades
commission	commissions
cruise	cruises
retreat	retreats
harmony	harmonies
throat	throats
mediator	mediators
herring	herrings
mannerism	mannerisms
distinction	distinctions
delicacy	delicacies
thought	thoughts
setting	settings
partner	partners
falcon	falcons
centurion	centurions
mariner	mariners
toaster	toasters
slogan	slogans
barber	barbers
shutter	shutters
injustice	injustices
carnation	carnations
crossword	crosswords
painter	painters
spice	spices
bridge	bridges
runway	runways
motor	motors
memoir	memoirs
irritant	irritants
accessory	accessories
pamphlet	pamphlets
dryer	dryers
harmonica	harmonicas
employer	employers
mystic	mystics
mull	mulls
snare	snares
occurrence	occurrences
attachment	attachments
lecture	lectures
practice	practices
deputy	deputies
ram	rams
cannibal	cannibals
bearer	bearers
sector	sectors
patrolman	patrolmen
symbol	symbols
boulder	boulders
squat	squats
bee	bees
servant	servants
qualifier	qualifiers
friendly	friendlies
cockpit	cockpits
homemaker	homemakers
gig	gigs
hatch	hatches
pastor	pastors
grove	groves
equivalent	equivalents
megabyte	megabytes
drill	drills
cake	cakes
majesty	majesties
arrest	arrests
achievement	achievements
wagon	wagons
volunteer	volunteers
tab	tabs
instrument	instruments
plunge	plunges
gigabyte	gigabytes
fundamentalist	fundamentalists
highlight	highlights
drifter	drifters
controller	controllers
gay	gays
fortune	fortunes
compartment	compartments
objection	objections
realist	realists
stipend	stipends
arcade	arcades
handler	handlers
mystery	mysteries
motorcade	motorcades
lawn	lawns
transistor	transistors
