patent	patents
cocoon	cocoons
contradict	contradicts
infect	infects
wine	wines
associate	associates
organize	organizes
labor	labors
launch	launches
mar	mars
circle	circles
rocket	rockets
notify	notifies
disappear	disappears
degrade	degrades
snack	snacks
repair	repairs
age	ages
encompass	encompasses
decorate	decorates
wound	wounds
reel	reels
pillow	pillows
cite	cites
rick	ricks
gust	gusts
defect	defects
scent	scents
play	plays
crack	cracks
leak	leaks
show	shows
testify	testifies
continue	continues
occupy	occupies
stack	stacks
jump	jumps
bellow	bellows
devour	devours
tip	tips
nibble	nibbles
hit	hits
possess	possesses
underestimate	underestimates
dupe	dupes
promise	promises
enrich	enriches
shrink	shrinks
captain	captains
knight	knights
pardon	pardons
permeate	permeates
spice	spices
bump	bumps
appeal	appeals
recite	recites
confide	confides
frank	franks
neglect	neglects
absorb	absorbs
construct	constructs
champion	champions
allow	allows
afford	affords
hum	humes
prosecute	prosecutes
secure	secures
sort	sorts
tangle	tangles
allege	alleges
default	defaults
patrol	patrols
handcuff	handcuffs
search	searches
rail	rails
thwart	thwarts
shuffle	shuffles
function	functions
exclude	excludes
winter	winters
warn	warns
evolve	evolves
personify	personifies
surprise	surprises
plate	plates
present	presents
inject	injects
submit	submits
swim	swims
espouse	espouses
typify	typifies
people	peoples
entertain	entertains
inspire	inspires
rush	rushes
bail	bails
multiply	multiplies
out	outs
package	packages
button	buttons
soap	soaps
cup	cups
squall	squalls
reconvene	reconvenes
trade	trades
cube	cubes
subside	subsides
chorus	choruses
veer	veers
pretend	pretends
chair	chairs
parallel	parallels
clown	clowns
machine	machines
embed	embeds
formulate	formulates
page	pages
beach	beaches
rivet	rivets
flank	flanks
shackle	shackles
interview	interviews
flick	flicks
hand	hands
grass	grasses
kill	kills
evaluate	evaluates
afflict	afflicts
clamp	clamps
shutter	shutters
inhibit	inhibits
donate	donates
experience	experiences
elicit	elicits
demonstrate	demonstrates
case	cases
sand	sands
cap	caps
scatter	scatters
lack	lacks
complicate	complicates
derive	derives
dissipate	dissipates
complete	completes
deny	denies
comprise	comprises
foresee	foresees
bone	bones
barge	barges
squirt	squirts
brush	brushes
curb	curbs
fragment	fragments
spew	spews
fix	fixes
achieve	achieves
enhance	enhances
toot	toots
pirate	pirates
consist	consists
fumble	fumbles
sorrow	sorrows
sigh	sighs
impair	impairs
overwhelm	overwhelms
detail	details
camp	camps
hive	hives
swarm	swarms
reach	reaches
undermine	undermines
enshrine	enshrines
discharge	discharges
tender	tenders
barrack	barracks
brawl	brawls
fold	folds
breach	breaches
rape	rapes
assess	assesses
stamp	stamps
amend	amends
punt	punts
pervade	pervades
toe	toes
tune	tunes
scud	scuds
pressure	pressures
thicken	thickens
catch	catches
protest	protests
menace	menaces
repeat	repeats
syndicate	syndicates
bath	baths
rein	reins
weave	weaves
rung	rungs
precipitate	precipitates
tail	tails
conspire	conspires
mass	masses
provoke	provokes
grace	graces
happen	happens
hook	hooks
stand	stands
erupt	erupts
induce	induces
deteriorate	deteriorates
downgrade	downgrades
minimize	minimizes
deal	deals
scrape	scrapes
interface	interfaces
dominate	dominates
earn	earns
herald	heralds
utilize	utilizes
hawk	hawks
finish	finishes
retrace	retraces
disappoint	disappoints
intern	interns
twist	twists
flood	floods
break	breaks
scrap	scraps
pour	pours
cramp	cramps
verify	verifies
enact	enacts
stomp	stomps
imitate	imitates
pilot	pilots
beggar	beggars
sucker	suckers
kneel	kneels
bond	bonds
preclude	precludes
wing	wings
ladder	ladders
bubble	bubbles
harp	harps
harden	hardens
scope	scopes
infuse	infuses
cane	canes
defend	defends
kidnap	kidnaps
owe	owes
duet	duets
wander	wanders
off	offs
tow	tows
leaf	leafs
tie	ties
bolster	bolsters
override	overrides
perform	performs
profit	profits
expose	exposes
manage	manages
slate	slates
classify	classifies
shoe	shoes
bite	bites
govern	governs
punch	punches
tighten	tightens
pause	pauses
peep	peeps
bargain	bargains
recover	recovers
spirit	spirits
confer	confers
lord	lords
bum	bums
compile	compiles
flush	flushes
sandbag	sandbags
endorse	endorses
ooze	oozes
firm	firms
up	ups
sprint	sprints
abandon	abandons
border	borders
whale	whales
conjure	conjures
reveal	reveals
obtain	obtains
clone	clones
distinguish	distinguishes
crowd	crowds
free	frees
sip	sips
dive	dives
carve	carves
ferry	ferries
link	links
unravel	unravels
bust	busts
brood	broods
harness	harnesses
equal	equals
wish	wishes
dish	dishes
pronounce	pronounces
degenerate	degenerates
wage	wages
reassure	reassures
clarify	clarifies
nominate	nominates
gum	gums
breeze	breezes
wait	waits
sink	sinks
fly	flies
breed	breeds
identify	identifies
review	reviews
chicken	chickens
inch	inches
grudge	grudges
rave	raves
convene	convenes
spear	spears
term	terms
conform	conforms
rat	rates
crystallize	crystallizes
melt	melts
con	cons
parrot	parrots
comb	combs
bring	brings
stew	stews
sortie	sorties
meet	meets
reiterate	reiterates
obstruct	obstructs
take	takes
hike	hikes
meter	meters
die	dies
foreshadow	foreshadows
moan	moans
sham	shams
applaud	applauds
scare	scares
gall	galls
infuriate	infuriates
prevail	prevails
balk	balks
buffet	buffets
blaze	blazes
carry	carries
drip	drips
pad	pads
erode	erodes
estimate	estimates
wash	washes
trek	treks
corrupt	corrupts
inflict	inflicts
lump	lumps
seal	seals
black	blacks
stifle	stifles
swirl	swirls
group	groups
involve	involves
bootleg	bootlegs
imagine	imagines
picnic	picnics
tout	touts
counterfeit	counterfeits
finger	fingers
tuck	tucks
audition	auditions
kid	kids
bloom	blooms
jolt	jolts
establish	establishes
interact	interacts
gross	grosses
listen	listens
guess	guesses
parody	parodies
terminate	terminates
teach	teaches
file	files
overlook	overlooks
provide	provides
range	ranges
mail	mails
collapse	collapses
revel	revels
flirt	flirts
add	adds
change	changes
deprive	deprives
dwell	dwells
increase	increases
devote	devotees
witness	witnesses
emit	emits
analyze	analyzes
flip	flips
expire	expires
discount	discounts
fine	fines
coo	coos
scar	scars
shed	sheds
grab	grabs
ramp	ramps
weep	weeps
evidence	evidences
approve	approves
suspect	suspects
handle	handles
marry	marries
hear	hears
lime	limes
expand	expands
join	joins
mob	mobs
rag	rages
document	documents
shut	shuts
juice	juices
overstate	overstates
wonder	wonders
jaw	jaws
compliment	compliments
gate	gates
trigger	triggers
met	mets
hug	hugs
move	moves
dispatch	dispatches
feud	feuds
race	races
litter	litters
roast	roasts
shovel	shovels
exploit	exploits
save	saves
ornament	ornaments
tattoo	tattoos
decline	declines
knock	knocks
retake	retakes
overtake	overtakes
steer	steers
curve	curves
concern	concerns
row	rows
sober	sobers
recede	recedes
deplore	deplores
archive	archives
buss	busses
cycle	cycles
perch	perches
rock	rocks
bid	bids
lobby	lobbies
drive	drives
pin	pines
stink	stinks
coach	coaches
charter	charters
comment	comments
presume	presumes
rake	rakes
dispense	dispenses
praise	praises
tour	tours
bar	bars
lament	laments
torture	tortures
sympathize	sympathizes
badger	badgers
pledge	pledges
resist	resists
note	notes
resurrect	resurrects
appear	appears
zero	zeros
dictate	dictates
roar	roars
furnish	furnishes
recap	recaps
nettle	nettles
mate	mates
institute	institutes
dislike	dislikes
freak	freaks
trust	trusts
designate	designates
tremble	trembles
interest	interests
emanate	emanates
release	releases
lunch	lunches
flex	flexes
strap	straps
boil	boils
trap	traps
attribute	attributes
ease	eases
restrict	restricts
flourish	flourishes
sun	suns
palm	palms
chaperone	chaperones
home	homes
spring	springs
stereotype	stereotypes
pervert	perverts
haul	hauls
earmark	earmarks
implant	implants
befriend	befriends
stuff	stuffs
collect	collects
marshal	marshals
reinforce	reinforces
censor	censors
bend	bends
fetch	fetches
train	trains
erase	erases
muzzle	muzzles
shower	showers
dream	dreams
fork	forks
sneak	sneaks
irritate	irritates
starch	starches
bribe	bribes
embarrass	embarrasses
oil	oils
press	presses
urge	urges
unify	unifies
presuppose	presupposes
plunge	plunges
accept	accepts
garland	garlands
watch	watches
boast	boasts
instruct	instructs
invent	invents
phase	phases
quote	quotes
bin	bins
roam	roams
garage	garages
poll	polls
skipper	skippers
disapprove	disapproves
nose	noses
riot	riots
fruit	fruits
turn	turns
restate	restates
sanction	sanctions
renounce	renounces
await	awaits
push	pushes
shake	shakes
encounter	encounters
reprise	reprises
signal	signals
lessen	lessens
cheer	cheers
falter	falters
claim	claims
entitle	entitles
boo	boos
lecture	lectures
burn	burns
conflict	conflicts
contact	contacts
spit	spits
predate	predates
incite	incites
merit	merits
tee	tees
highlight	highlights
patch	patches
watt	watts
slash	slashes
wield	wields
murder	murders
download	downloads
augur	augurs
solidify	solidifies
manifest	manifests
surcharge	surcharges
baby	babies
doubt	doubts
look	looks
second	seconds
hallmark	hallmarks
flock	flocks
caper	capers
facilitate	facilitates
coast	coasts
mean	means
compel	compels
project	projects
permit	permits
threaten	threatens
spiral	spirals
squabble	squabbles
tramp	tramps
correct	corrects
talk	talks
fret	frets
grub	grubs
map	maps
administer	administers
put	puts
bicycle	bicycles
kit	kits
exchange	exchanges
embrace	embraces
brook	brooks
better	betters
emphasize	emphasizes
affect	affects
relieve	relieves
thrill	thrills
declare	declares
block	blocks
ream	reams
specialize	specializes
slur	slurs
bolt	bolts
compete	competes
materialize	materializes
neck	necks
snatch	snatches
bag	bags
taper	tapers
appreciate	appreciates
ruffle	ruffles
remake	remakes
tether	tethers
spend	spends
design	designs
enlist	enlists
number	numbers
rest	rests
walk	walks
shun	shuns
stun	stuns
thunder	thunders
orphan	orphans
affiliate	affiliates
thrust	thrusts
party	parties
balance	balances
ward	wards
descend	descends
gesture	gestures
fry	fries
gas	gases
scalp	scalps
color	colors
kick	kicks
crew	crews
affirm	affirms
glimmer	glimmers
clothe	clothes
tailor	tailors
frighten	frightens
purchase	purchases
shadow	shadows
cop	copes
splinter	splinters
slim	slims
emerge	emerges
gather	gathers
depress	depresses
pain	pains
suspend	suspends
heel	heels
lace	laces
inherit	inherits
elect	elects
excuse	excuses
disagree	disagrees
ask	asks
cream	creams
ring	rings
level	levels
port	ports
reside	resides
define	defines
isolate	isolates
commune	communes
reunite	reunites
deviate	deviates
list	lists
attend	attends
pension	pensions
sail	sails
snake	snakes
bottom	bottoms
chronicle	chronicles
lever	levers
boost	boosts
season	seasons
injure	injures
allocate	allocates
overcome	overcomes
tumble	tumbles
deem	deems
man	mans
ignore	ignores
dot	dots
canvass	canvasses
vest	vests
faint	faints
corral	corrales
skirt	skirts
exist	exists
address	addresses
force	forces
fake	fakes
course	courses
panic	panics
pinch	pinches
indulge	indulges
entail	entails
progress	progresses
whistle	whistles
weed	weeds
invest	invests
state	states
center	centers
post	posts
trouser	trousers
layer	layers
discuss	discusses
silence	silences
crate	crates
approach	approaches
bear	bears
wildcat	wildcats
underlie	underlies
claw	claws
still	stills
brace	braces
stock	stocks
cooperate	cooperates
drum	drums
own	owns
render	renders
fish	fishes
joke	jokes
will	wills
sever	severs
draft	drafts
curse	curses
rev	revs
summer	summers
forget	forgets
consider	considers
tab	tabs
assemble	assembles
dismiss	dismisses
fume	fumes
reign	reigns
slop	slopes
admire	admires
club	clubs
wave	waves
load	loads
rage	rages
assault	assaults
excite	excites
commission	commissions
filter	filters
task	tasks
strip	strips
tally	tallies
fracture	fractures
escort	escorts
hurdle	hurdles
partner	partners
strive	strives
generate	generates
scout	scouts
team	teams
toss	tosses
rescue	rescues
rejoin	rejoins
seed	seeds
cool	cools
keep	keeps
stagger	staggers
ink	inks
breast	breasts
drape	drapes
giggle	giggles
reminisce	reminisces
anticipate	anticipates
deflect	deflects
sustain	sustains
motivate	motivates
cluster	clusters
export	exports
brain	brains
confront	confronts
school	schools
detest	detests
clerk	clerks
wrap	wraps
vibrate	vibrates
inspect	inspects
being	beings
hazard	hazards
engulf	engulfs
fight	fights
swoop	swoops
refer	refers
offset	offsets
step	steps
lunge	lunges
authorize	authorizes
warrant	warrants
want	wants
cork	corks
massage	massages
lick	licks
scan	scans
bus	buses
proportion	proportions
mention	mentions
advance	advances
scale	scales
guard	guards
engender	engenders
powder	powders
hog	hogs
pal	pales
bud	buds
spoil	spoils
cone	cones
cope	copes
bow	bows
register	registers
vet	vets
loan	loans
decide	decides
type	types
sow	sows
eliminate	eliminates
mine	mines
preach	preaches
import	imports
exude	exudes
strain	strains
mutate	mutates
prejudice	prejudices
soldier	soldiers
concur	concurs
influence	influences
glow	glows
answer	answers
sugar	sugars
sling	slings
pun	puns
prefer	prefers
swab	swabs
hold	holds
travel	travels
nest	nests
tread	treads
ripple	ripples
short	shorts
ball	balls
offend	offends
denote	denotes
maneuver	maneuvers
dose	doses
fashion	fashions
bench	benches
withhold	withholds
mask	masks
silver	silvers
uphold	upholds
tick	ticks
stem	stems
cling	clings
streak	streaks
express	expresses
relapse	relapses
ghost	ghosts
beat	beats
promote	promotes
blemish	blemishes
site	sites
request	requests
speed	speeds
line	lines
torpedo	torpedoes
shave	shaves
caution	cautions
click	clicks
reprint	reprints
mess	messes
truck	trucks
inform	informs
house	houses
autograph	autographs
chance	chances
snap	snaps
plant	plants
tax	taxes
plot	plots
bode	bodes
cough	coughs
view	views
amuse	amuses
lop	lopes
fire	fires
precede	precedes
pool	pools
focus	focuses
collide	collides
stain	stains
format	formats
encourage	encourages
theorize	theorizes
spotlight	spotlights
rear	rears
mist	mists
form	forms
delve	delves
differentiate	differentiates
dissolve	dissolves
pride	prides
retire	retires
bound	bounds
buffer	buffers
aggregate	aggregates
stimulate	stimulates
contract	contracts
heal	heals
anger	angers
single	singles
fox	foxes
culture	cultures
report	reports
dedicate	dedicates
box	boxes
rang	ranges
barrel	barrels
bless	blesses
stabilize	stabilizes
confirm	confirms
rank	ranks
scuffle	scuffles
frown	frowns
jerk	jerks
stall	stalls
shine	shines
trail	trails
ferret	ferrets
make	makes
hitch	hitches
remember	remembers
exceed	exceeds
email	emails
struggle	struggles
saddle	saddles
solicit	solicits
content	contents
champ	champs
chase	chases
embargo	embargoes
engineer	engineers
roster	rosters
screen	screens
span	spans
round	rounds
berth	berths
try	tries
fog	fogs
depart	departs
drop	drops
cripple	cripples
arm	arms
knuckle	knuckles
campaign	campaigns
bunker	bunkers
name	names
ride	rides
book	books
brown	browns
ponder	ponders
awaken	awakens
dodge	dodges
truss	trusses
accommodate	accommodates
beaver	beavers
microwave	microwaves
forge	forges
love	loves
fall	falls
match	matches
wire	wires
touch	touches
soup	soups
pill	pills
commute	commutes
profess	professes
horn	horns
summarize	summarizes
clean	cleans
air	airs
lower	lowers
negotiate	negotiates
extend	extends
art	arts
slump	slumps
haunt	haunts
lift	lifts
diminish	diminishes
discourage	discourages
grunt	grunts
surpass	surpasses
crease	creases
rally	rallies
merge	merges
resort	resorts
revive	revives
chat	chats
subsidize	subsidizes
occur	occurs
seep	seeps
attack	attacks
visit	visits
suggest	suggests
outlaw	outlaws
queue	queues
qualify	qualifies
input	inputs
denounce	denounces
purport	purports
gun	guns
prune	prunes
anchor	anchors
linger	lingers
avoid	avoids
convert	converts
rotate	rotates
board	boards
supplement	supplements
alienate	alienates
fool	fools
top	tops
founder	founders
incur	incurs
disintegrate	disintegrates
chime	chimes
record	records
jingle	jingles
tilt	tilts
serenade	serenades
track	tracks
signify	signifies
recount	recounts
sue	sues
dull	dulles
crank	cranks
intimate	intimates
activate	activates
brighten	brightens
infringe	infringes
conclude	concludes
time	times
choke	chokes
oblige	obliges
undertake	undertakes
punish	punishes
peg	pegs
cure	cures
resemble	resembles
perfume	perfumes
slit	slits
foot	foots
riddle	riddles
scold	scolds
staff	staffs
envelop	envelopes
discipline	disciplines
nuke	nukes
substitute	substitutes
crawl	crawls
quiver	quivers
drink	drinks
howl	howls
wheel	wheels
shaft	shafts
publish	publishes
alter	alters
chew	chews
aim	aims
devalue	devalues
ski	skies
blunder	blunders
franchise	franchises
suppose	supposes
cook	cooks
think	thinks
notice	notices
reprimand	reprimands
constitute	constitutes
blank	blanks
recollect	recollects
apply	applies
power	powers
snowball	snowballs
miss	misses
motion	motions
waltz	waltzes
contend	contends
complain	complains
sneeze	sneezes
operate	operates
swallow	swallows
pass	passes
growl	growls
refuse	refuses
satisfy	satisfies
crane	cranes
check	checks
select	selects
prolong	prolongs
inconvenience	inconveniences
indict	indicts
attempt	attempts
chuckle	chuckles
crayon	crayons
loom	looms
meander	meanders
widen	widens
voice	voices
temper	tempers
ensure	ensures
inquire	inquires
remedy	remedies
value	values
sit	sits
help	helps
overdose	overdoses
burden	burdens
stoop	stoops
quicken	quickens
commemorate	commemorates
vote	votes
narrow	narrows
connote	connotes
bounce	bounces
dust	dusts
solve	solves
parcel	parcels
pulse	pulses
worship	worships
invoke	invokes
caricature	caricatures
glory	glories
bandage	bandages
wad	wads
clock	clocks
backfire	backfires
flow	flows
safeguard	safeguards
adore	adores
ratify	ratifies
father	fathers
eagle	eagles
tot	tots
propagate	propagates
carol	carols
reflect	reflects
stroll	strolls
rewrite	rewrites
reap	reaps
skip	skips
skate	skates
shipwreck	shipwrecks
pawn	pawns
buckle	buckles
speak	speaks
tempt	tempts
rerun	reruns
partition	partitions
mix	mixes
demand	demands
account	accounts
compromise	compromises
dock	docks
maximize	maximizes
articulate	articulates
copy	copies
cry	cries
swear	swears
unlock	unlocks
lash	lashes
wind	winds
crumble	crumbles
recognize	recognizes
bruise	bruises
initiate	initiates
engage	engages
scratch	scratches
curtain	curtains
veto	vetoes
tutor	tutors
salt	salts
boom	booms
indicate	indicates
shelter	shelters
pose	poses
ache	aches
bean	beans
displace	displaces
hail	hails
hinder	hinders
crook	crooks
tackle	tackles
grip	grips
mind	minds
spook	spooks
sleep	sleeps
trump	trumps
twig	twigs
negative	negatives
dare	dares
shear	shears
respond	responds
raise	raises
embody	embodies
grow	grows
leap	leaps
understand	understands
spy	spies
allude	alludes
reward	rewards
putter	putters
ration	rations
pedal	pedals
grant	grants
inflate	inflates
ticket	tickets
trickle	trickles
harm	harms
bluff	bluffs
clutch	clutches
smoke	smokes
nudge	nudges
rob	robs
attach	attaches
benefit	benefits
cow	cows
flee	flees
telescope	telescopes
rack	racks
remark	remarks
educate	educates
puff	puffs
transmit	transmits
restore	restores
treasure	treasures
intrude	intrudes
argue	argues
letter	letters
stride	strides
bathe	bathes
imply	implies
nick	nicks
convict	convicts
have	haves
jet	jets
last	lasts
resign	resigns
slack	slacks
remind	reminds
section	sections
down	downs
proclaim	proclaims
grit	grits
slick	slicks
rose	roses
contain	contains
plume	plumes
clip	clips
determine	determines
describe	describes
leaflet	leaflets
stoke	stokes
petition	petitions
exempt	exempts
relax	relaxes
illustrate	illustrates
slip	slips
smile	smiles
romance	romances
fancy	fancies
inhabit	inhabits
rope	ropes
nurse	nurses
heat	heats
cleave	cleaves
belie	belies
probe	probes
pertain	pertains
assign	assigns
fuel	fuels
disguise	disguises
bunch	bunches
limit	limits
halt	halts
sentence	sentences
condition	conditions
guest	guests
blow	blows
voyage	voyages
pot	pots
cement	cements
transplant	transplants
troop	troops
park	parks
approximate	approximates
messenger	messengers
shop	shops
rumble	rumbles
strut	struts
trouble	troubles
forgive	forgives
mortgage	mortgages
hound	hounds
glass	glasses
postpone	postpones
fuse	fuses
fiddle	fiddles
slice	slices
regiment	regiments
validate	validates
recommend	recommends
split	splits
arrange	arranges
mill	mills
cue	cues
tone	tones
relish	relishes
dart	darts
boss	bosses
lie	lies
taunt	taunts
foil	foils
sense	senses
steam	steams
court	courts
muster	musters
agree	agrees
escape	escapes
farm	farms
flop	flops
correlate	correlates
laugh	laughs
specify	specifies
bug	bugs
bleed	bleeds
migrate	migrates
egg	eggs
simulate	simulates
noise	noises
go	goes
best	bests
credit	credits
lose	loses
swipe	swipes
succeed	succeeds
cage	cages
shiver	shivers
abound	abounds
squeak	squeaks
entrance	entrances
code	codes
card	cards
rip	rips
distance	distances
pipe	pipes
frame	frames
kite	kites
withdraw	withdraws
drug	drugs
produce	produces
combat	combats
mouth	mouths
sub	subs
explode	explodes
loathe	loathes
medal	medals
hack	hacks
beep	beeps
occasion	occasions
spare	spares
please	pleases
hurt	hurts
courier	couriers
major	majors
shelve	shelves
unleash	unleashes
characterize	characterizes
adjust	adjusts
proposition	propositions
reform	reforms
bore	bores
picture	pictures
coincide	coincides
spark	sparks
mourn	mourns
unfold	unfolds
transfer	transfers
observe	observes
opt	opts
detour	detours
regret	regrets
run	runs
dash	dashes
shoot	shoots
weigh	weighs
lurk	lurks
pierce	pierces
network	networks
hate	hates
mother	mothers
quarrel	quarrels
certify	certifies
relate	relates
pave	paves
shy	shies
action	actions
intercept	intercepts
justify	justifies
congratulate	congratulates
blood	bloods
headline	headlines
hose	hoses
strengthen	strengthens
throng	throngs
differ	differs
brick	bricks
taste	tastes
rehearse	rehearses
contrast	contrasts
glimpse	glimpses
call	calls
auction	auctions
create	creates
rate	rates
brand	brands
invite	invites
grade	grades
prophesy	prophesies
cut	cuts
broadside	broadsides
diagnose	diagnoses
sprain	sprains
comfort	comforts
predominate	predominates
thrive	thrives
yell	yells
wreak	wreaks
roll	rolls
wrench	wrenches
equate	equates
videotape	videotapes
dispose	disposes
grind	grinds
prevent	prevents
reef	reefs
advertise	advertises
celebrate	celebrates
base	bases
spout	spouts
string	strings
purge	purges
floor	floors
wake	wakes
part	parts
suffer	suffers
cross	crosses
skid	skids
conduct	conducts
bundle	bundles
chart	charts
peel	peels
face	faces
impose	imposes
joint	joints
pale	pales
pit	pits
couple	couples
roof	roofs
branch	branches
compress	compresses
exacerbate	exacerbates
corner	corners
hedge	hedges
steel	steels
zone	zones
taxi	taxis
stress	stresses
tank	tanks
behave	behaves
trial	trials
mull	mulls
desert	deserts
rap	rapes
conceal	conceals
bog	bogs
consult	consults
root	roots
propel	propels
translate	translates
nod	nodes
leave	leaves
blanket	blankets
phone	phones
march	marches
mistake	mistakes
summon	summons
mount	mounts
suit	suits
jar	jars
poke	pokes
plug	plugs
buck	bucks
crash	crashes
factor	factors
tend	tends
reason	reasons
boot	boots
hull	hulls
sack	sacks
build	builds
crunch	crunches
intervene	intervenes
pen	pens
shack	shacks
bark	barks
like	likes
game	games
improvise	improvises
broker	brokers
bare	bares
empower	empowers
piece	pieces
compute	computes
disarm	disarms
spot	spots
right	rights
supervise	supervises
develop	develops
bottle	bottles
fluctuate	fluctuates
sight	sights
deter	deters
bomb	bombs
splash	splashes
diagram	diagrams
decrease	decreases
exhaust	exhausts
brave	braves
sock	socks
float	floats
gasp	gasps
disturb	disturbs
railroad	railroads
vow	vows
average	averages
herd	herds
spike	spikes
gang	gangs
solder	solders
glance	glances
impart	imparts
oversee	oversees
order	orders
care	cares
modify	modifies
cheek	cheeks
apologize	apologizes
steal	steals
shout	shouts
mint	mints
jam	james
assist	assists
rifle	rifles
crusade	crusades
reply	replies
devastate	devastates
intensify	intensifies
cheat	cheats
ace	aces
clog	clogs
brew	brews
strike	strikes
insert	inserts
stir	stirs
profile	profiles
introduce	introduces
whisper	whispers
reduce	reduces
accuse	accuses
bitch	bitches
simmer	simmers
benchmark	benchmarks
annex	annexes
lurch	lurches
favor	favors
queer	queers
firebomb	firebombs
overlap	overlaps
snipe	snipes
ignite	ignites
beef	beefs
battle	battles
mimic	mimics
revolve	revolves
upload	uploads
rely	relies
market	markets
braid	braids
stint	stints
doodle	doodles
ballot	ballots
contest	contests
abstract	abstracts
avert	averts
assert	asserts
rise	rises
net	nets
date	dates
lob	lobes
tan	tans
source	sources
parade	parades
surface	surfaces
respect	respects
telephone	telephones
brief	briefs
shepherd	shepherds
encapsulate	encapsulates
disadvantage	disadvantages
defer	defers
halve	halves
mike	mikes
spin	spines
hover	hovers
table	tables
assume	assumes
adapt	adapts
evaporate	evaporates
persuade	persuades
risk	risks
scheme	schemes
flower	flowers
sear	sears
poison	poisons
issue	issues
yellow	yellows
hole	holes
minor	minors
zip	zips
dawn	dawns
bulge	bulges
stick	sticks
scrub	scrubs
cock	cocks
overshadow	overshadows
interpret	interprets
decry	decries
slum	slums
depict	depicts
exile	exiles
unite	unites
feature	features
smash	smashes
screw	screws
verge	verges
sponge	sponges
transform	transforms
paint	paints
believe	believes
carpet	carpets
latch	latches
blind	blinds
parole	paroles
stab	stabs
divide	divides
tense	tenses
dent	dents
overcharge	overcharges
log	logs
timetable	timetables
foul	fouls
moor	moors
bed	beds
stretch	stretches
career	careers
expel	expels
charge	charges
levy	levies
pore	pores
defeat	defeats
tunnel	tunnels
crown	crowns
tolerate	tolerates
pony	ponies
chip	chips
invoice	invoices
doll	dolls
tell	tells
portend	portends
seduce	seduces
illuminate	illuminates
begin	begins
improve	improves
crow	crows
guide	guides
challenge	challenges
disable	disables
cache	caches
feed	feeds
compare	compares
fan	fans
blame	blames
outstrip	outstrips
fund	funds
work	works
soar	soares
shock	shocks
diet	diets
symbolize	symbolizes
converge	converges
pant	pants
uncover	uncovers
duck	ducks
doorstep	doorsteps
hollow	hollows
separate	separates
canoe	canoes
propose	proposes
extract	extracts
word	words
kink	kinks
enter	enters
intersect	intersects
remove	removes
massacre	massacres
lounge	lounges
wrinkle	wrinkles
greet	greets
bale	bales
shorten	shortens
pound	pounds
hope	hopes
rival	rivals
sex	sexes
come	comes
result	results
triumph	triumphs
keyboard	keyboards
tongue	tongues
send	sends
rent	rents
wrestle	wrestles
pencil	pencils
retrieve	retrieves
fizzle	fizzles
share	shares
figure	figures
resume	resumes
resource	resources
bestow	bestows
judge	judges
dam	dams
jack	jacks
batter	batters
worry	worries
imprint	imprints
intend	intends
transport	transports
hide	hides
even	evens
lapse	lapses
hint	hints
lope	lopes
squeeze	squeezes
waste	wastes
accompany	accompanies
stone	stones
soften	softens
borrow	borrows
master	masters
simplify	simplifies
ruin	ruins
return	returns
criticize	criticizes
gauge	gauges
monitor	monitors
supply	supplies
stage	stages
belt	belts
route	routes
bind	binds
wipe	wipes
lamb	lambs
write	writes
troll	trolls
announce	announces
deck	decks
iron	irons
pasture	pastures
outline	outlines
animate	animates
convince	convinces
insure	insures
provision	provisions
underline	underlines
crop	crops
mark	marks
plague	plagues
mug	mugs
lure	lures
purse	purses
plateau	plateaus
endanger	endangers
participate	participates
dick	dicks
tart	tarts
funnel	funnels
breathe	breathes
narrate	narrates
omit	omits
sponsor	sponsors
stable	stables
ditch	ditches
elbow	elbows
preserve	preserves
infer	infers
persist	persists
flap	flaps
adjourn	adjourns
alleviate	alleviates
recycle	recycles
cushion	cushions
portion	portions
mime	mimes
back	backs
react	reacts
whip	whips
shoulder	shoulders
posit	posits
shield	shields
plow	plows
find	finds
stalk	stalks
shin	shines
toll	tolls
delight	delights
revert	reverts
originate	originates
use	uses
compound	compounds
amplify	amplifies
weekend	weekends
ridicule	ridicules
weld	welds
raid	raids
picket	pickets
fur	furs
lap	laps
subject	subjects
neutralize	neutralizes
dress	dresses
treat	treats
needle	needles
stump	stumps
marvel	marvels
reappear	reappears
dispute	disputes
stomach	stomachs
prepare	prepares
slap	slaps
cease	ceases
process	processes
photocopy	photocopies
snow	snows
fault	faults
charm	charms
shatter	shatters
bucket	buckets
represent	represents
start	starts
smother	smothers
damage	damages
lend	lends
dog	dogs
cost	costs
scream	screams
blast	blasts
suck	sucks
dissent	dissents
wobble	wobbles
cause	causes
repeal	repeals
acquit	acquits
flag	flags
insist	insists
terrorize	terrorizes
outweigh	outweighs
quip	quips
tape	tapes
glide	glides
subscribe	subscribes
outperform	outperforms
thumb	thumbs
catalogue	catalogues
pioneer	pioneers
yield	yields
pile	piles
putt	putts
confuse	confuses
clot	clots
blister	blisters
cart	carts
shrug	shrugs
support	supports
beard	beards
murmur	murmurs
hamper	hampers
graft	grafts
prop	props
predict	predicts
cashier	cashiers
contribute	contributes
reference	references
connect	connects
devise	devises
sag	sages
exaggerate	exaggerates
feel	feels
bypass	bypasses
solo	solos
trace	traces
eclipse	eclipses
retain	retains
surge	surges
paw	paws
torch	torches
maintain	maintains
gore	gores
pump	pumps
ground	grounds
embark	embarks
sob	sobs
snarl	snarls
direct	directs
gutter	gutters
refund	refunds
statement	statements
tack	tacks
barricade	barricades
license	licenses
attest	attests
compact	compacts
live	lives
access	accesses
slot	slots
manufacture	manufactures
ship	ships
restructure	restructures
moderate	moderates
rattle	rattles
budget	budgets
score	scores
cannon	cannons
pursue	pursues
hassle	hassles
collar	collars
give	gives
disclose	discloses
puncture	punctures
nerve	nerves
know	knows
sacrifice	sacrifices
restrain	restrains
drain	drains
stretcher	stretchers
overpower	overpowers
say	says
arrive	arrives
clump	clumps
gee	gees
fear	fears
dwarf	dwarfs
long	longs
subpoena	subpoenas
spoon	spoons
phrase	phrases
police	polices
bracket	brackets
sound	sounds
cuff	cuffs
insult	insults
matter	matters
queen	queens
knee	knees
end	ends
refill	refills
orbit	orbits
unload	unloads
hire	hires
reproduce	reproduces
abide	abides
examine	examines
beetle	beetles
stockpile	stockpiles
video	videos
twin	twins
quarter	quarters
staple	staples
land	lands
boycott	boycotts
conquer	conquers
pocket	pockets
regard	regards
class	classes
gear	gears
plan	plans
reconcile	reconciles
prostitute	prostitutes
further	furthers
polish	polishes
replicate	replicates
calculate	calculates
preview	previews
learn	learns
pull	pulls
perceive	perceives
mushroom	mushrooms
prohibit	prohibits
scroll	scrolls
spawn	spawns
nurture	nurtures
settle	settles
crave	craves
remain	remains
quarry	quarries
renew	renews
weasel	weasels
syringe	syringes
deserve	deserves
acquire	acquires
towel	towels
dance	dances
necessitate	necessitates
quake	quakes
horse	horses
depend	depends
thank	thanks
chain	chains
plummet	plummets
advise	advises
suppress	suppresses
debate	debates
birdie	birdies
space	spaces
concede	concedes
execute	executes
bowl	bowls
soil	soils
pack	packs
complement	complements
index	indexes
ally	allies
clue	clues
acknowledge	acknowledges
radio	radios
throw	throws
recreate	recreates
desire	desires
investigate	investigates
store	stores
experiment	experiments
peter	peters
prime	primes
distribute	distributes
reopen	reopens
stunt	stunts
fade	fades
fence	fences
stitch	stitches
install	installs
lodge	lodges
label	labels
signpost	signposts
mandate	mandates
ready	readies
condemn	condemns
alternate	alternates
storm	storms
consolidate	consolidates
white	whites
adorn	adorns
bill	bills
sample	samples
offer	offers
recess	recesses
envisage	envisages
groan	groans
segment	segments
handicap	handicaps
choose	chooses
exercise	exercises
cradle	cradles
sweep	sweeps
green	greens
succumb	succumbs
jab	jabs
pepper	peppers
flare	flares
slam	slams
object	objects
subordinate	subordinates
rhyme	rhymes
thread	threads
tube	tubes
wedge	wedges
vacation	vacations
recall	recalls
sweat	sweats
upset	upsets
sport	sports
pluck	plucks
lease	leases
rub	rubs
drill	drills
nap	naps
quarterback	quarterbacks
waive	waives
host	hosts
reaffirm	reaffirms
obscure	obscures
prescribe	prescribes
seem	seems
forward	forwards
guarantee	guarantees
fit	fits
audit	audits
pan	panes
effect	effects
skewer	skewers
jibe	jibes
ravage	ravages
smack	smacks
spell	spells
draw	draws
spill	spills
broadcast	broadcasts
shade	shades
do	does
rupture	ruptures
hammer	hammers
refrain	refrains
abuse	abuses
quit	quits
explain	explains
disregard	disregards
shred	shreds
doctor	doctors
mature	matures
crush	crushes
accomplish	accomplishes
overthrow	overthrows
edit	edits
supersede	supersedes
low	lows
bully	bullies
dip	dips
underscore	underscores
field	fields
garden	gardens
program	programs
regulate	regulates
paddle	paddles
sandwich	sandwiches
gorge	gorges
reserve	reserves
slave	slaves
tire	tires
fill	fills
belly	bellies
outfit	outfits
mold	molds
crap	craps
axe	axes
prospect	prospects
salute	salutes
grate	grates
accumulate	accumulates
drift	drifts
room	rooms
bunk	bunks
divorce	divorces
kiss	kisses
stroke	strokes
venture	ventures
arouse	arouses
swap	swaps
sprout	sprouts
revolt	revolts
station	stations
counter	counters
shore	shores
tile	tiles
outrage	outrages
band	bands
stipulate	stipulates
corroborate	corroborates
climax	climaxes
regain	regains
vent	vents
notch	notches
dilute	dilutes
fringe	fringes
aspire	aspires
channel	channels
transpire	transpires
tool	tools
belong	belongs
savage	savages
star	stars
trumpet	trumpets
glorify	glorifies
double	doubles
admonish	admonishes
mastermind	masterminds
wane	wanes
raffle	raffles
study	studies
swing	swings
privilege	privileges
rule	rules
twitch	twitches
communicate	communicates
escalate	escalates
counteract	counteracts
scoop	scoops
duplicate	duplicates
tower	towers
coil	coils
clap	claps
shroud	shrouds
filibuster	filibusters
exit	exits
grill	grills
dampen	dampens
brag	brags
explore	explores
stub	stubs
price	prices
vary	varies
cater	caters
vindicate	vindicates
distract	distracts
torment	torments
penetrate	penetrates
worm	worms
implement	implements
read	reads
confess	confesses
groom	grooms
accelerate	accelerates
chant	chants
are	ares
smear	smears
spread	spreads
brake	brakes
concentrate	concentrates
finance	finances
total	totals
butcher	butchers
calm	calms
shuttle	shuttles
wrong	wrongs
edge	edges
stare	stares
slide	slides
spur	spurs
bank	banks
sign	signs
rebuild	rebuilds
empty	empties
interchange	interchanges
broaden	broadens
well	wells
straddle	straddles
seek	seeks
bat	bats
head	heads
roger	rogers
umpire	umpires
foster	fosters
research	researches
waffle	waffles
welcome	welcomes
muse	muses
usher	ushers
bristle	bristles
throttle	throttles
plead	pleads
bang	bangs
oppose	opposes
exhibit	exhibits
seize	seizes
protect	protects
text	texts
sprinkle	sprinkles
mumble	mumbles
prompt	prompts
enable	enables
cultivate	cultivates
schedule	schedules
hump	humps
gut	guts
plane	planes
zoom	zooms
sharpen	sharpens
stumble	stumbles
commence	commences
parachute	parachutes
vaporize	vaporizes
gamble	gambles
dwindle	dwindles
wag	wages
shift	shifts
realize	realizes
attract	attracts
open	opens
combine	combines
toast	toasts
clinch	clinches
overrun	overruns
structure	structures
endure	endures
resent	resents
amount	amounts
accrue	accrues
pine	pines
invade	invades
cancel	cancels
peer	peers
arch	arches
wiggle	wiggles
pattern	patterns
hot	hots
excel	excels
discard	discards
encode	encodes
switch	switches
rig	rigs
receive	receives
discover	discovers
overturn	overturns
detect	detects
proof	proofs
dry	dries
implicate	implicates
enlarge	enlarges
exert	exerts
blend	blends
flash	flashes
scoff	scoffs
shudder	shudders
cover	covers
vacuum	vacuums
bury	buries
overhear	overhears
burst	bursts
clam	clams
pickle	pickles
update	updates
craft	crafts
size	sizes
creep	creeps
overflow	overflows
ape	apes
climb	climbs
revisit	revisits
tear	tears
ensue	ensues
clear	clears
crest	crests
pivot	pivots
correspond	corresponds
knit	knits
elevate	elevates
manipulate	manipulates
front	fronts
minister	ministers
grieve	grieves
weather	weathers
caddy	caddies
position	positions
squirrel	squirrels
balloon	balloons
replace	replaces
graduate	graduates
measure	measures
misunderstand	misunderstands
utter	utters
heighten	heightens
advocate	advocates
alert	alerts
resonate	resonates
violate	violates
gaze	gazes
fail	fails
impede	impedes
worsen	worsens
wink	winks
demo	demos
daydream	daydreams
weaken	weakens
angle	angles
circulate	circulates
defy	defies
lock	locks
cloud	clouds
see	sees
recur	recurs
minute	minutes
digest	digests
upgrade	upgrades
deliver	delivers
pole	poles
drown	drowns
swamp	swamps
contemplate	contemplates
beg	begs
slow	slows
radiate	radiates
rampage	rampages
sap	saps
tug	tugs
cable	cables
grapple	grapples
blossom	blossoms
can	cans
point	points
lean	leans
bias	biases
recruit	recruits
blur	blurs
debut	debuts
fell	fells
hoard	hoards
void	voids
flake	flakes
sole	soles
instance	instances
style	styles
barbecue	barbecues
act	acts
disperse	disperses
sideline	sidelines
outpace	outpaces
baffle	baffles
impress	impresses
query	queries
fax	faxes
stream	streams
interrupt	interrupts
eyeball	eyeballs
exemplify	exemplifies
prize	prizes
proceed	proceeds
divert	diverts
count	counts
curl	curls
languish	languishes
blockade	blockades
clash	clashes
sing	sings
bayonet	bayonets
need	needs
critique	critiques
win	wins
include	includes
paper	papers
slug	slugs
gain	gains
closet	closets
distort	distorts
trip	trips
model	models
place	places
rain	rains
landscape	landscapes
counsel	counsels
rebel	rebels
integrate	integrates
light	lights
evoke	evokes
martyr	martyrs
slaughter	slaughters
retail	retails
resolve	resolves
set	sets
award	awards
pace	paces
perk	perks
feather	feathers
dial	dials
incorporate	incorporates
surrender	surrenders
pig	pigs
hunt	hunts
dunk	dunks
sting	stings
retaliate	retaliates
coin	coins
duel	duels
trick	tricks
garrison	garrisons
appoint	appoints
decree	decrees
coat	coats
intrigue	intrigues
aid	aids
jail	jails
spurt	spurts
mirror	mirrors
shape	shapes
dramatize	dramatizes
wreck	wrecks
warp	warps
prod	prods
consent	consents
cruise	cruises
eat	eats
retreat	retreats
veil	veils
refute	refutes
survive	survives
loop	loops
square	squares
skin	skins
loose	looses
deposit	deposits
nail	nails
rabbit	rabbits
stop	stops
disrupt	disrupts
chop	chops
elude	eludes
sketch	sketches
stake	stakes
preside	presides
water	waters
negate	negates
butt	butts
reject	rejects
drag	drags
close	closes
beam	beams
film	films
bob	bobs
loosen	loosens
snag	snags
speculate	speculates
serve	serves
burrow	burrows
adhere	adheres
wail	wails
swell	swells
peak	peaks
commit	commits
rout	routes
seat	seats
freeze	freezes
forbid	forbids
bridge	bridges
motor	motors
reckon	reckons
cascade	cascades
accord	accords
hop	hops
reimburse	reimburses
pick	picks
adopt	adopts
envision	envisions
weight	weights
snare	snares
control	controls
target	targets
mop	mops
require	requires
service	services
compose	composes
ram	rams
gen	genes
question	questions
pitch	pitches
cast	casts
harvest	harvests
command	commands
knot	knots
arise	arises
admit	admits
deepen	deepens
console	consoles
rebound	rebounds
assure	assures
moo	moos
feast	feasts
referee	referees
transcend	transcends
squat	squats
hatch	hatches
swan	swans
initial	initials
dub	dubs
author	authors
bike	bikes
expect	expects
wear	wears
follow	follows
confine	confines
humiliate	humiliates
capture	captures
flatten	flattens
consume	consumes
photograph	photographs
vanish	vanishes
interfere	interferes
flame	flames
shell	shells
gig	gigs
despise	despises
hesitate	hesitates
fare	fares
core	cores
wither	withers
lead	leads
cake	cakes
alarm	alarms
puzzle	puzzles
pair	pairs
arrest	arrests
buff	buffs
muscle	muscles
couch	couches
comply	complies
pop	pops
print	prints
reverse	reverses
delegate	delegates
volunteer	volunteers
forecast	forecasts
accent	accents
drone	drones
locate	locates
impact	impacts
slope	slopes
vault	vaults
enforce	enforces
unveil	unveils
moon	moons
become	becomes
shampoo	shampoos
bother	bothers
perpetuate	perpetuates
discriminate	discriminates
sell	sells
hinge	hinges
wall	walls
surround	surrounds
prove	proves
scramble	scrambles
cave	caves
undergo	undergoes
