price	worth
play	act
bull	cattle
fife	flute
spud	bore
catalan	romance
princess	aristocrat
choreograph	mastermind
fluctuate	move
levitation	phenomenon
jasmine	shrub
cover	compensate
railroad	transport
suspense	doubt
bestow	give
perfection	improvement
skate	sport
coach	trainer
hike	walk
curtain	blind
mainline	inject
progress	develop
piggyback	change
choreograph	make
system	method
vent	refresh
companion	traveler
binder	harvester
offer	project
suffice	satisfy
dominate	influence
channel	transmission
predictor	information
mistake	identify
toll	fee
maoist	advocate
score	fact
equality	status
aeronautics	physic
brand	firewood
vomit	expulsion
spit	utter
taro	root
change	replace
paraphrase	repeat
job	unfortunate
warn	order
galaxy	collection
dodge	falsehood
delete	remove
make	look
dismemberment	mutilation
match	contest
hear	probe
share	use
hibernate	sleep
cat	hitch
tack	sail
steamroller	vehicle
smoothie	beverage
bend	movement
quarter	coin
creditor	person
overrun	overshoot
economy	action
overall	work-clothing
bead	mold
bustle	framework
clutch	pedal
stern	rear
peppermint	mint
decompression	ease
laziness	rest
sum	collection
sensitivity	feel
mole	insectivore
ottoman	turk
hani	loloish
friend	person
discouragement	deterrence
supremacist	advocate
pepper	attack
pit	trap
screamer	waterfowl
subscribe	offer
raffle	lottery
mismanagement	management
hoard	store
leer	look
digest	permit
recall	concentrate
beat	sail
rib	cut
mission	work
warn	rede
armistice	peace
tip	give
output	product
rapporteur	registrar
priority	earliness
apology	defense
inject	insert
decapitate	kill
fiefdom	organization
taro	arum
trophy	award
translate	determine
deal	board
distaff	sphere
prion	particle
site	tract
separate	move
anti	person
crate	containerful
survivalist	person
strife	conflict
craft	fashion
scrape	make
crash	fail
belle	girl
screw	tighten
harmonize	relate
modify	add
cotton	thread
snapshot	photograph
interest	power
sink	descent
crowd	situation
key	list
develop	change
crimp	lock
fall	cut
pound	symbol
kino	tree
divert	send
tracer	detective
intention	goal
roulette	curve
rehabilitate	restore
teapot	pot
intercept	point
hover	hesitate
proof	knead
mar	damage
cock	penis
sheet	line
steam	rise
bond	security
signal	incitement
ultimatum	demand
nominate	choose
guesthouse	house
frown	grimace
stick	margarine
predicament	difficulty
copyright	document
adoption	bless
frame	plan
tier	rope
pellet	ball
indemnity	protection
mercy	relief
overreact	react
reef	low
diffuse	spread
fortieth	rank
mandate	commission
hail	precipitation
dissipate	live
cock	cant
villainy	evil
shield	armor
slider	fastball
slot	trail
maker	creator
riser	person
make	assemble
wing	organ
retrieve	bring
rose	pink
balk	area
irrationality	insanity
library	build
interlude	perform
language	faculty
mantle	symbol
state	express
mistake	nonaccomplishment
ticket	summon
strongman	dictator
ridicule	disrespect
snort	exhale
mark	bespeak
interfere	impede
hog	swine
box	encase
conserve	keep
cancel	declare
inventiveness	creativity
rat	hire
snuff	tobacco
bowl	wheel
camouflage	disguise
mediation	negotiation
peacock	peafowl
direction	path
clear	empty
incarnate	realize
sit	session
scale	order
oppression	persecution
criminal	principal
repair	improvement
yakuza	gangster
decontamination	removal
clock	timepiece
limb	arc
lodge	house
drugstore	shop
conservation	preservation
underscore	stress
deflection	aberrance
argyle	design
domain	set
swathe	bandage
raise	increase
fault	responsibility
point	be
glimpse	indication
ammonium	ammonia
cold	temperature
inhibitor	substance
property	attribute
former	first
favor	see
access	reach
comfort	aid
wield	manipulate
dock	herb
mushroom	vegetable
blow	shape
infomercial	commercial
capability	aptitude
audience	gather
bottom	supply
yana	hokan
suffocate	become
hamper	basket
phase	point
hone	whetstone
pretend	claim
blacksmith	smith
meniscus	surface
transshipment	transportation
polish	perfection
yoga	exercise
implode	collapse
machinery	system
rap	perform
crosstalk	noise
match	supply
hedge	minimize
rerun	air
movement	action
die	ache
cutthroat	murderer
scabies	infection
puncture	mishap
heavyweight	boxer
aspen	poplar
typecast	cast
rescue	recovery
exaggeration	misrepresentation
potash	hydroxide
strand	form
bookmaker	gambler
benediction	prayer
excursion	journey
fit	test
yogurt	food
bud	flower
mount	attach
practice	cognition
patron	owner
apathy	feel
kashmiri	dard
network	communicate
gel	change
reinstatement	restoration
vowel	letter
nomination	condition
presuppose	imply
remainder	sell
turnpike	expressway
grotesque	art
salvage	commodity
tile	application
distribution	commerce
point	repair
space	put
stool	seat
chinese	sinitic
wed	party
pour	supply
lymphoma	cancer
reverence	attitude
limp	walk
word	statement
yoke	join
publicist	communicator
disturb	affect
reminder	experience
excess	overabundance
humorist	entertainer
pouch	sac
ass	fool
include	see
tread	squash
madras	fabric
bacteria	microorganism
receive	change
legend	story
solicitation	entreaty
blunt	weaken
attrition	sorrow
intensity	degree
faction	clique
comedian	actor
lime	citrus
imitate	copy
salt	spice
flexibility	malleability
gallbladder	bladder
central	workplace
rig	gear
affinity	resemblance
crab	steer
bid	invitation
joke	act
hull	remove
anasazi	indian
sensation	stir
abduct	pull
consummation	completion
batten	strengthen
annulment	dissolution
daily	newspaper
prank	decorate
runner	traveler
picket	fasten
two	digit
mobilize	move
masai	nilotic
breadbasket	region
mean	instrumentality
enhancement	improvement
thump	sound
crunch	press
retreat	travel
raft	travel
quota	allotment
pit	confront
virus	microorganism
negativity	polarity
pepper	zest
usurpation	capture
shroud	line
stagger	walk
melatonin	hormone
measure	evaluate
rosebud	bud
bellow	cry
horn	alarm
stubbornness	intractability
tree	chase
spell	speech
settler	migrant
stuff	concoction
forge	workplace
occupier	serviceman
leg	support
float	artifact
disparage	knock
carry	include
style	write
ripen	change
stabile	sculpture
game	activity
brush	implement
capital	center
furrow	trench
trick	device
bruise	damage
think	concentrate
extension	stretch
pearl	gather
evil	transgression
stepson	stepchild
intern	doctor
ruin	thwart
overhaul	regenerate
airline	hose
regulation	dominance
tank	store
chop	move
encouragement	hope
yacht	boat
hardship	misfortune
dazzle	amaze
equilibrium	proprioception
pillow	put
drop	drug
archive	collect
spaniard	european
medalist	golfer
reckon	bill
incriminate	suggest
overlap	cover
diagonal	line
carton	box
shoot	attempt
develop	grow
calendar	table
capitalize	calculate
paddock	pen
check	attack
corrective	device
performer	entertainer
cut	design
deliverable	product
waist	area
manna	sap
orgy	rite
class	collection
disorder	state
contraction	word
burberry	raincoat
whet	stimulate
antagonist	drug
spit	skewer
scorch	dry
rocker	adolescent
drop	change
rampage	act
schoolyard	yard
preempt	supplant
catch	witness
combine	union
authority	control
see	think
crate	box
bow	weapon
turkey	flop
genius	creativity
ladder	degree
dorian	citizenry
mistreatment	practice
join	connect
mackintosh	fabric
illuminate	decorate
propagate	transmit
cherokee	iroquoian
affirmative	avowal
curse	raise
extremity	region
discretion	sagacity
uncle	kinsman
hundredth	rank
airspace	atmosphere
wear	deteriorate
circumference	size
supplement	constitute
protection	extortion
errand	trip
mode	condition
parcel	divide
yaw	deviate
stylist	artist
cooper	craftsman
convocation	gather
earshot	range
auction	sale
subscription	agreement
penthouse	apartment
scoreboard	signboard
rest	pause
roll	pronounce
dark	unenlightenment
bong	sound
combination	collection
fidelity	accuracy
terrain	tract
drone	pipe
magic	supernaturalism
juggle	rearrangement
place	rank
handful	containerful
ballpoint	pen
cornet	brass
dish	nutriment
lag	flip
mousse	toiletry
stump	perplex
stick	butter
occupation	acquire
flush	water
shortness	lowness
disk	plate
breakdown	analysis
aperture	open
hurl	throw
prostitute	woman
clear	pass
checkmate	beat
pit	corrosion
racism	bias
regalia	gear
checkerboard	board
decoration	artifact
seaweed	alga
staff	symbol
sleeper	saboteur
treasury	depository
balmoral	shoe
strawberry	birthmark
odds	likelihood
bull	policeman
nan	bread
flight	trip
mire	bog
promote	change
reunify	unite
spat	hit
commission	operation
blackmail	extortion
vote	choice
kite	hawk
fellow	member
discover	gestate
dove	pacifist
tournament	contest
crimson	red
appraisal	estimate
temperance	restraint
incursion	entrance
searchlight	light
hyperbole	trope
delinquency	nonpayment
trademark	file
stub	hit
cram	study
clamp	fasten
elbow	bend
art	creation
folly	play
pole	rod
strangulation	disorder
fall	kill
carbine	rifle
clue	wind
academy	institution
truss	tie
understand	believe
complicity	guilt
prevail	exist
beat	shape
infancy	immaturity
aromatherapy	therapy
roach	hairdo
minister	work
contempt	disrespect
alliance	connection
gunpowder	explosive
whirlwind	windstorm
capture	change
censor	counterintelligence
extra	edition
model	sculpture
dependability	responsibility
insight	sensibility
bombard	attack
department	sector
kink	difficulty
diplomacy	negotiation
eviction	compulsion
libel	defamation
tear	cry
cannery	factory
olive	relish
godfather	godparent
cricketer	athlete
turban	headdress
gatherer	person
volunteer	act
offset	print
malaysian	malay
advantage	asset
drumhead	membrane
combine	contribute
deck	porch
cut	free
deploy	spread
urinate	excrete
overcharge	charge
tense	affect
compromise	accommodation
toboggan	sled
draw	necessitate
bifurcation	branch
pickup	collection
test	be
contagion	communication
vocabulary	cognition
tip	end
shower	party
toupee	hairpiece
handicap	advantage
exodus	escape
grade	ablaut
reversal	judgment
jumper	jacket
soar	rise
label	designate
normalize	change
market	industry
saddle	burden
pea	legume
hopper	receptacle
kappa	letter
butch	lesbian
excuse	request
orient	lie
matrix	enclosure
run	administration
translate	move
version	turn
pump	supply
finisher	painter
drift	passageway
bowel	center
distance	size
sound	sensation
land	object
warship	ship
card	cardboard
wesleyan	methodist
newfoundland	dog
wave	gesture
brainwash	persuade
advent	season
sura	section
broaden	increase
festival	celebration
horn	noisemaker
temple	build
delinquency	misbehavior
crucifixion	execution
instruction	code
advance	sum
host	entertain
rib	bone
net	fabric
range	arrange
erode	damage
complicate	change
magazine	press
pali	prakrit
single	hit
attach	join
dogfight	battle
murderer	criminal
cable	telecommunicate
genome	order
quartz	mineral
disregard	mistreatment
hum	sound
endow	enable
affiliate	join
finance	credit
regulate	decide
shona	bantu
commune	covenant
interlocutor	conversationalist
compartment	space
affiliate	organization
illiterate	ignoramus
actuator	mechanism
dramatization	write
guide	direct
repellent	compound
photocopy	copy
trailblazer	scout
kindle	ignite
neutrality	ph
steam	vapor
decelerate	decrease
compel	induce
protectorate	district
defense	protection
engineer	operator
choke	suffocation
reappearance	appearance
barber	hairdresser
confucian	believer
coat	dress
dictate	govern
immolation	sacrifice
sprout	grow
fistfight	contend
chair	seat
dive	descend
resemblance	likeness
attend	listen
agitate	disturb
aversion	avoidance
copper	conductor
vision	imagination
erotic	sensualist
machine	person
crossfire	fire
desert	tract
ligament	attachment
execute	enforce
racer	car
glare	brightness
diagnosis	designation
bow	gesture
launder	wash
loom	weave
bypass	avoid
tide	float
surprise	change
continue	act
scorer	lumberman
demonstrator	reformer
natural	achiever
decorate	change
close	move
seize	hook
dutch	nation
attack	operation
heritage	practice
label	radioisotope
clapboard	cover
jerk	push
analysis	reason
move	change
track	groove
intersection	join
huckleberry	shrub
transplant	insert
reconvene	convene
envelop	cover
mold	edge
crumb	morsel
cayenne	capsicum
afghan	blanket
fault	crack
scar	symptom
fiber	material
server	computer
tithe	levy
trespass	wrongdoing
livery	uniform
depth	degree
numbness	symptom
eagle	score
sidestep	step
invalid	remove
flip	propel
narrator	speaker
entree	course
access	code
weed	garment
cup	containerful
retention	possession
reformer	disputant
dinner	meal
cradle	hold
court	residence
read	indicate
heel	end
transom	crosspiece
transgression	wrongdoing
broaden	development
search	operation
workspace	space
variety	difference
hood	cover
overcharge	cheat
pour	crowd
refurbish	regenerate
clutch	brood
shingle	rock
reassure	assure
part	object
paradigm	inflection
representation	cooperation
orthodoxy	unoriginality
retract	pull
glow	feel
sinker	pitch
apparatus	equipment
mother	yeast
convention	assembly
berber	afroasiatic
deployment	preparation
colloquy	conversation
reciprocate	act
accent	pronunciation
react	act
poison	kill
gown	university
seal	affix
ruffle	fold
newsroom	office
lance	pierce
loss	failure
contact	representative
womanhood	position
end	morpheme
steal	baseball
chatter	noise
drink	help
hurdle	vault
heart	whist
mahogany	wood
transsexual	person
forfeit	abandon
stepmother	stepparent
aggravation	intensification
arbitration	judgment
wolf	eat
freeze	solidify
tomorrow	day
gusto	enthusiasm
lyre	harp
tie	cord
censor	official
call	challenge
buck	react
casualty	victim
callus	harden
taxi	reaction
ride	travel
bye	concession
buff	modify
dieter	person
yard	field
spread	cover
admonish	knock
shadow	recourse
absurdity	folly
slate	intend
box	containerful
remuneration	payment
canopy	fabric
cat	flog
carry	grow
search	examine
crest	line
aim	goal
streak	flash
attrition	friction
contractor	party
skyline	outline
synchronize	arrange
translate	transmit
post	install
nebula	symptom
chocolate	food
cut	move
islamophobia	bias
homicide	kill
landslide	slide
belgian	european
mugger	robber
i	letter
muse	source
dulcimer	zither
sod	guy
suggestion	persuasion
footprint	trace
muster	gather
carousel	ride
elapse	advance
circulate	publicize
absurd	situation
gantry	framework
synchronize	adjust
consult	research
cofounder	founder
frigate	warship
struggle	attempt
parcel	allotment
interrogate	air
reimburse	refund
junkyard	yard
solicitor	petitioner
deadlock	situation
backwoods	country
approach	movement
infection	incident
prejudice	disadvantage
avalanche	descend
carrot	herb
steam	anger
parity	conservation
good	quality
master	officer
meal	foodstuff
homelessness	condition
voice	singer
invocation	prayer
witness	watch
platform	document
censor	deletion
ambiance	environment
landmark	structure
recall	call
cream	beat
reel	film
expression	squeeze
execution	process
sector	tract
bend	ordinary
expedite	help
amnesty	pardon
termite	insect
poet	writer
pudding	dessert
touch	affect
register	affect
square	number
sale	agreement
crown	vertex
north	direction
cavity	space
correlate	match
immunity	invulnerability
sail	structure
compress	wedge
bloc	alliance
differentiate	dissimilate
visit	afflict
voodoo	cult
tailor	adapt
award	grant
imam	leader
stooge	act
tightrope	rope
edition	issue
brainwash	indoctrinate
scale	reach
appeal	proceed
emirate	position
tao	pueblo
land	arrive
check	bill
flux	rate
till	soil
messiah	savior
repression	control
patty	candy
snag	hew
offspring	consequence
storm	blow
minstrel	sing
portal	entrance
record	fact
chinchilla	coat
bailey	court
exhaust	empty
scuffle	hoe
strike	pitch
pollack	gadoid
honeycomb	structure
dateline	date
upstage	treat
darn	repair
primitive	person
shell	emerge
dishwasher	laborer
fiefdom	domain
refresher	beverage
scoop	remove
settle	accept
stride	advancement
sap	solution
commercialize	change
support	influence
seal	device
corn	cereal
blanch	cook
smoothness	effortlessness
help	promote
cub	novice
failure	fortune
pride	satisfaction
acquaintance	relationship
lock	engage
staple	fasten
worry	perturb
bless	prayer
catch	attract
bury	implant
howl	noise
torture	persecution
pallet	platform
straitjacket	garment
divert	withdraw
solo	activity
soy	legume
pack	package
sombrero	hat
price	determine
crouch	bend
verge	bind
clarion	brass
entertain	contemplate
simple	herb
master	record
whine	complain
orient	position
spelt	wheat
reuben	sandwich
rouge	makeup
rim	hoop
huddle	cluster
price	cost
phrase	arrange
tusk	tooth
birth	begin
add	form
luxury	wealth
tenderness	compassion
motivation	act
fly	change
pacify	establish
assimilation	relationship
grotto	cave
thai	tai
petter	lover
envision	imagine
modesty	decency
construction	constituent
ogre	giant
wadi	gully
glass	insert
swagger	act
certificate	award
shy	startle
maneuver	motion
burglary	felony
wire	string
place	item
hand	collection
reveille	awaken
spool	wind
run	move
archipelago	land
reaction	force
irish	whiskey
smother	kill
plot	tract
rocker	musician
reflector	device
italian	european
center	position
fox	fur
bounce	eject
stock	lumber
pot	implant
undergo	change
marble	rock
wine	regale
conglomeration	sphere
roper	decoy
recite	re-create
clam	shellfish
cool	change
lavender	shrub
text	passage
butt	stock
train	teach
outwit	surpass
refusal	denial
restructure	structure
mildew	fungus
simpleton	person
hail	object
gamble	speculation
menu	bill
case	person
anoint	application
hacienda	house
drunkard	drinker
list	lean
substitute	exchange
cognizance	know
ban	prohibition
minimum	limit
groan	utter
absolve	forgive
cheer	applaud
doodle	draw
stucco	coat
theorem	idea
guidance	management
poison	change
smorgasbord	buffet
fade	termination
saver	owner
disappearance	happen
biometrics	statistic
testimony	assertion
rat	defect
reversible	garment
scrapbook	album
neighbor	border
paddle	swim
stile	upright
geisha	japanese
hesitate	delay
eagerness	enthusiasm
loss	decline
void	space
admiration	bless
fibrillation	twitch
decode	cryptography
unwind	move
selflessness	cooperation
asian	inhabitant
installment	payment
discrepancy	difference
videocassette	cassette
pick	provoke
tropic	latitude
invitation	letter
slop	food
bore	excavation
rag	week
heaviness	sadness
declare	affirm
shipbuilding	construction
clutter	noise
jaw	bone
west	location
detail	information
wright	craftsman
hand	side
waterproof	coat
karen	tibeto-burman
hope	desire
thermostat	regulator
pin	promise
scramble	travel
wet	change
snatch	weightlift
sit	serve
bluff	deception
firewood	fuel
partnership	business
assign	choose
volley	discharge
stretcher	litter
disunity	disagreement
proof	produce
bow	thank
placement	activity
double	multiplication
influence	consequence
catch	get
deviation	statistic
tiebreaker	overtime
inculcate	drill
excuse	absolve
bookcase	furniture
scavenger	animal
cabin	compartment
wrestle	battle
hangover	survival
tyrant	person
enactment	legislation
homophobia	bias
nip	cut
immigrate	migrate
embroidery	needlework
omission	disregard
helplessness	dependence
take	win
answer	state
poison	corrupt
latvian	european
accept	receive
microbiology	biology
cough	expectorate
revival	improvement
jacob	patriarch
catheterization	operation
aperture	hole
fascination	enchantment
race	compete
heroine	woman
magnification	expansion
fund	invest
clothe	cover
sideline	demote
reinstatement	condition
wound	person
well	source
research	investigate
simulation	model
gospel	truth
salon	shop
flank	formation
slick	comb
construction	interpretation
sheep	follower
toehold	foothold
desirability	good
discomfort	suffer
supply	give
smallness	amount
cover	broach
ute	shoshonean
proportional	quantity
icon	symbol
interpreter	program
tumble	toss
acknowledge	accept
malt	milkshake
suitor	admirer
pharmacology	medicine
blow	move
reign	govern
devour	enjoy
crawl	travel
wash	stand
sink	descend
attend	care
sharpshooter	schooner
source	obtain
frontier	boundary
understudy	actor
decker	artifact
volition	faculty
legitimacy	lawfulness
order	state
japan	lacquer
indigo	shrub
backup	duplicate
wear	deterioration
career	progress
appropriateness	propriety
subscribe	agree
cookie	text
ally	consort
response	manner
shag	tobacco
pull	force
think	belief
refectory	dining-hall
replicate	duplicate
rep	fabric
enslavement	capture
blender	mixer
capitalist	person
cooperation	practice
stock	have
american	inhabitant
californian	american
identifier	symbol
relieve	mitigate
curtain	furnish
tyrant	dictator
raise	make
finalize	end
stir	move
kurdish	iranian
point	measure
letter	award
dirt	dirtiness
measure	abstraction
meow	utter
entail	estate
wrack	destruction
european	inhabitant
forceps	extractor
bushman	nomad
presbyterian	protestant
appreciation	thank
claw	extremity
glance	hit
devastate	overwhelm
snowball	ball
visibility	salience
reference	action
rifle	search
hit	consume
fix	change
whoop	cry
wallow	delight
keel	carina
vision	experience
cloak	cover
gape	stare
namibian	african
naturalist	philosopher
nest	retreat
wind	exhalation
bind	relate
alight	land
founder	sink
eat	consume
agape	love
organize	initiate
battery	team
businessperson	capitalist
dehydration	thirst
hang	execute
couple	unit
rome	leadership
coverage	news
composer	musician
parole	promise
termination	end
mulch	cover
vignette	photograph
loop	circle
gent	gentleman
mimic	imitate
telemarketing	sell
weasel	person
button	add
feline	carnivore
thrush	singer
detox	ward
luster	glaze
covet	envy
repudiation	rejection
shyness	timidity
bud	sprout
infatuation	passion
let	induce
belch	reflex
then	point
arbitrage	trade
administer	give
dwell	exist
dispensation	distribution
clinic	session
sprawl	position
abhorrence	hate
activism	policy
beach	land
carrier	chemical
cobble	repair
soak	heat
culture	taste
reality	actuality
greek	european
finisher	racer
blast	bombard
halogen	group
precipitate	descend
encourage	inspire
herr	title
lineup	line
comprehension	understand
infiltration	penetration
trance	unconsciousness
cur	coward
posture	conceit
jean	workwear
undertone	tone
shell	remove
literature	write
helmet	headdress
finisher	worker
trade	occupation
punch	blow
thread	guide
comb	plate
accelerator	pedal
booster	dose
resourcefulness	resource
pyramid	arrange
repayment	payment
malfunction	fail
readiness	state
accuse	charge
dip	swim
orchestrator	arranger
imprint	stamp
western	sandwich
horn	process
onslaught	trouble
peeve	temper
grace	state
wicca	cult
remover	mover
optimize	act
game	contest
affirm	declare
multiplex	telecommunication
booster	thief
brake	stop
logistics	provision
diocese	jurisdiction
bridle	answer
topper	wit
metamorphosis	transformation
barrister	lawyer
honor	conformity
toe	force
fort	station
revoke	cancel
rib	remark
dollar	bill
meter	quantify
surfeit	fullness
rotation	turn
regard	look
like	kind
flagpole	staff
televangelist	evangelist
wish	desire
caffeine	alkaloid
vault	jump
closet	confine
retraction	motion
fear	emotion
elimination	analysis
eulogy	praise
rank	line
splash	noise
feel	look
simplicity	quality
advantage	benefit
footnote	note
disposition	property
czar	tyrant
class	league
strange	person
session	conference
yang	principle
play	compete
forsake	renunciation
brush	cover
schlock	merchandise
clinch	maneuver
fall	slope
third	rank
hell	region
laxative	purgative
underdog	failure
glengarry	cap
kleenex	tissue
canon	priest
humor	playfulness
make	cause
strike	read
master	creation
restrict	limit
harrow	plow
blur	weaken
keep	have
stratification	condition
sinker	weight
picture	typification
buffalo	overawe
peony	flower
urethra	duct
capacity	function
slovene	slavic
maturity	date
hysteria	fear
shine	be
philosophy	belief
backhand	hit
discord	disagreement
scrum	begin
chopper	tooth
successor	peer
brass	decoration
testament	creed
drug	agent
tan	trade
shark	cheat
disclaimer	repudiation
layer	artifact
breaker	quarryman
preach	lecture
shin	cut
palatine	bone
chef	cook
rent	tear
fulcrum	pivot
starlight	light
back	finance
angler	schemer
juniper	cypress
shadow	pursuit
gainer	dive
seaplane	airplane
cutoff	device
detector	rectifier
gaff	spike
fellowship	aid
fresco	paint
nautilus	submarine
curator	custodian
enamel	coat
average	total
bribe	pay
naturalness	likeness
warrant	security
suffocate	obstruct
pitcher	containerful
hush	water
mold	soil
collector	person
dump	discard
evaluator	authority
cover	touch
alarmist	communicator
municipality	gather
telescope	digest
precursor	material
sell	surrender
skate	glide
tin	plate
programmer	engineer
misfortune	fortune
smack	taste
pace	rate
pate	top
structure	cognition
kitchen	room
carbohydrate	macromolecule
develop	play
coven	assembly
blaze	depart
school	teach
redeem	exchange
flag	sign
starter	contestant
mix	combine
petitioner	applicant
component	part
loan	debt
butterfly	flit
oregano	origanum
racket	noise
feel	experience
inhalation	breath
methane	gas
blindfold	cover
suite	apartment
yawn	reflex
baptist	protestant
sob	cry
express	denote
extension	longness
juice	energy
monkey	primate
illinois	algonquian
manual	handbook
attraction	force
ebb	recede
start	advantage
receive	celebrate
spartan	greek
criticism	write
missile	rocket
investigate	probe
ding	sound
speedway	racetrack
field	region
peanut	legume
medium	substance
relation	deal
overhead	return
alderman	representative
workaholic	compulsive
hunt	search
tower	structure
thatch	hairdo
ramp	model
flatness	taste
depress	low
somersault	tumble
hypnotize	sedate
hypothesis	proposal
pyramid	deal
override	predominate
assay	substance
virtue	morality
tie	fasten
sink	decrease
decapitation	execution
front	confront
behest	command
conspire	interact
sedan	litter
skeleton	scandal
maximize	increase
breeze	wind
impound	restrain
shore	bind
lash	tie
sequester	take
piece	help
bonus	payment
poplar	wood
carry	travel
house	community
sedition	misdemeanor
atropine	alkaloid
berate	rebuke
like	see
tap	plug
strain	nervousness
explode	increase
inhibit	restrict
turntable	platform
hare	leporid
overshoot	blast
retire	recall
hymn	sing
news	information
internationalism	doctrine
double	badminton
caution	warn
space	placement
counterclaim	claim
hazel	brown
write	trace
huddle	crowd
rack	try
grind	reach
bear	support
depreciation	decrease
jealousy	envy
melon	gourd
crack	tell
hall	room
trunk	baggage
present	time
acquisition	acquire
sphinx	person
warrior	person
overrule	rule
abduction	motion
charge	cost
independence	victory
barbecue	cookout
gallery	balcony
buff	compound
astrophysicist	astronomer
telegraph	apparatus
lagoon	lake
bend	inclination
carrier	organism
watcher	person
absorb	sorb
fowler	hunter
toner	lotion
blockade	obstruction
iodide	halide
blast	fly
blur	representation
dynamo	generator
score	incision
humanist	scholar
acreage	area
concede	admit
aesthetic	philosophy
emerge	surface
seat	furniture
polyp	growth
specialization	career
manhole	hole
cusp	flap
field	handle
bring	make
transfusion	action
wallop	blow
business	sector
heretic	nonconformist
skate	ray
putter	work
supermodel	mannequin
fetch	action
approximation	join
cost	necessitate
shade	change
subject	thing
localize	restrict
community	ownership
professional	athlete
refresh	regenerate
maintain	affirm
print	write
mature	develop
electricity	energy
ink	liquid
utopian	reformer
inside	surface
transcendence	be
deny	control
adhere	adopt
jerk	misfit
bib	napkin
revolve	turn
phi	letter
volatility	irresoluteness
thing	happen
conclude	agree
honesty	righteousness
boyfriend	lover
joke	wit
continue	talk
stick	punishment
step	travel
retaliation	return
waste	discard
colonialism	exploitation
rejuvenate	regenerate
significance	mean
knit	needlework
saddle	seat
platter	flatware
totem	emblem
overreaction	reaction
raceway	canal
donkey	emblem
opinion	judgment
retardant	agent
leadership	status
reentry	return
unison	agreement
microscope	magnifier
dash	elegance
sheet	expanse
examine	question
cancer	person
snuff	inhale
glaze	coat
procure	obtain
core	torus
intimidation	fear
copy	write
stake	fasten
demand	request
care	protection
bead	decoration
bank	reserve
scatter	shower
chinaman	bowl
underbelly	abdomen
crawl	swim
accretion	addition
showboat	steamboat
overpower	beat
make	act
sign	contract
rapport	affinity
oak	wood
mouthpiece	tube
napalm	gasoline
beep	sound
striker	athlete
michael	archangel
happen	event
explosion	increase
decision	judgment
transport	diffusion
retirement	termination
epinephrine	hormone
rocker	support
well	vessel
siesta	nap
mess	disorderliness
utility	quality
turn	operate
row	array
swan	sweep
article	nonfiction
slop	ladle
differentiation	discrimination
wing	stage
review	evaluate
root	plant
quell	meet
suit	be
flour	foodstuff
declare	state
security	precaution
discipline	trait
countenance	face
savage	primitive
takeout	bid
specialize	modify
smash	demolish
lumberjack	jacket
cost	be
redeployment	deployment
furlough	leave
recognition	diplomacy
leak	disclosure
irradiation	illusion
masterpiece	accomplishment
bargain	agree
confidant	friend
peg	pierce
concept	idea
reflect	attest
invest	finance
pair	occur
pinhole	puncture
law	concept
sell	be
bey	man
phalanx	bone
share	mutuality
punk	igniter
replenish	fill
duckling	duck
core	sample
stave	slat
donor	benefactor
heat	supply
coverage	extent
manslaughter	homicide
become	fancify
sanitation	clean
counterbalance	compensation
pump	draw
tonic	note
copy	repetition
smack	snog
hoop	band
match	adjust
operate	happen
phrase	dance
map	represent
pool	stake
spark	trace
tension	condition
insecurity	danger
letter	document
perry	alcohol
islam	monotheism
scramble	change
mastodon	proboscidean
mohawk	haircut
truss	framework
clean	change
telecast	air
centrality	position
evade	act
paraphrase	reword
incorporate	include
polyp	coelenterate
duck	hunt
radio	communicate
damn	worthlessness
split	formation
totalitarian	disciple
finale	finish
mistress	lover
latitude	liberty
capsule	envelop
terrace	shape
symptom	evidence
comb	device
plan	think
runner	athlete
ecologist	biologist
shaker	sect
cross	affliction
track	belt
file	line
fry	cook
lock	hair
athleticism	energy
juncture	happen
backfire	fire
ethic	system
antiaircraft	gun
drift	accumulate
safe	strongbox
credit	title
track	path
emcee	host
maintenance	wrongdoing
assembly	machine
demolish	destroy
ration	share
cohesiveness	viscosity
ovary	gonad
mill	edge
beggar	impoverish
slick	sophisticate
equilibrium	situation
fireman	defender
veal	meat
zing	sound
carry	perform
vagueness	indistinctness
cashmere	fabric
eaves	overhang
politics	profession
transport	move
mate	beverage
gravestone	memorial
relieve	good
latitude	line
apply	denote
crash	occupy
forearm	limb
splash	sound
sake	benefit
come	exist
corridor	passageway
lemon	artifact
crossbow	bow
decompose	separate
renovation	improvement
corvette	warship
licorice	herb
beatnik	nonconformist
synthesize	compound
resonance	oscillation
hello	greet
flip	move
hell	trouble
thank	convey
furnish	instrumentality
bus	car
inhibit	restrain
deprive	withhold
tam	cap
miniature	copy
wildflower	wilding
hearth	area
speculation	investment
reconsider	see
intrusion	rock
end	surface
apostle	christian
department	division
navigate	steer
wink	gesticulate
zap	event
agitate	provoke
punctuation	group
augment	increase
break	escape
routine	procedure
worm	screw
utter	circulate
technology	profession
stream	exude
starve	deprive
malice	malevolence
reader	scholar
layer	region
terrace	tableland
distribute	give
shaver	man
steamer	ship
touch	contact
schism	division
polish	radiance
citation	award
pedal	operate
urology	medicine
resettlement	transportation
fang	canine
correct	treat
islam	civilization
concurrence	agreement
confuse	be
monument	site
incarnate	be
interlocutor	minstrel
allow	calculate
abrogation	cancellation
subcompact	car
duff	pudding
alabama	muskhogean
play	gamble
close	prosecute
sigma	letter
barrel	vessel
find	get
frontier	discipline
beat	fight
wart	keratosis
improvisation	expedient
yogi	philosopher
flick	peruse
agreement	plan
fire	element
repudiate	refuse
genotype	constitution
jubilee	anniversary
redouble	intensify
morbidity	incidence
augur	predict
header	jump
monarch	danaid
foothold	support
bench	assembly
cyclone	atmosphere
lead	evidence
devastation	ruin
accumulate	increase
raspberry	berry
hulk	ship
abortion	termination
drone	bee
plum	position
perforation	puncture
goddess	deity
fennel	herb
radio	broadcast
intend	plan
inning	turn
blackjack	bludgeon
proprietorship	ownership
hazard	danger
fluke	tail
meteor	light
liquor	broth
ambulatory	walk
stagflation	inflation
nickel	fiver
comforter	device
swindler	deceiver
gravestone	stone
return	run
cuticle	skin
pitch	descend
quarrel	arrow
paintbrush	applicator
multitude	group
latch	fasten
plush	fabric
buzz	fly
confession	declaration
wedge	iron
ginseng	root
hull	calyx
bogeyman	monster
back	strengthen
trill	note
doctrine	belief
claimant	applicant
stratification	shape
forage	search
eternity	be
redundancy	configuration
establish	initiate
trap	carriage
misread	read
inoculation	immunization
khaki	fabric
current	flow
wiper	worker
salvation	safety
absorb	learn
moray	eel
corrupt	modify
man	adult
desert	leave
collect	take
count	number
mate	friend
scepter	reign
tudor	dynasty
clasp	fastener
crackdown	suppression
grain	texture
respect	see
suppose	speculate
stipulate	contract
curve	pitch
mat	pad
adolescent	juvenile
rip	attack
reserve	withhold
incision	depression
punter	kicker
grind	dance
hoop	gird
builder	material
suck	absorb
linkage	fasten
change	coin
drag	clothe
match	equal
batiste	fabric
qin	dynasty
minivan	car
examiner	investigator
wash	cleanse
trailer	conveyance
veto	power
turnaround	area
amputation	operation
authenticity	credibility
signpost	sign
objectification	representation
speed	motion
shipwreck	ruin
hop	vine
occur	become
lace	weave
ply	layer
blackberry	berry
stuff	information
antidote	remedy
reviewer	critic
burn	blemish
profanity	utterance
custom	trade
corollary	inference
coat	cover
rehabilitation	restoration
tint	color
distinction	difference
diminish	decrease
assignment	distribution
spill	liquid
gene	sequence
refit	outfit
confuse	mistake
masthead	title
action	act
voice	express
earn	get
mannequin	dummy
nab	seize
intervention	proceed
federal	yankee
envelope	curve
settle	put
steam	emit
mush	drive
smother	smoke
water	food
practice	activity
receivables	asset
sirloin	cut
chain	ligament
incarnation	time
concourse	merge
whine	travel
market	activity
betray	unwrap
dredge	remove
cheat	deception
bar	forbid
burn	damage
vicar	clergyman
militarism	hawkishness
facade	misrepresentation
rent	contract
whitewash	wash
slur	talk
rack	torture
minster	cathedral
checkout	counter
canine	carnivore
chow	fare
recompense	correction
submit	propose
papyrus	sedge
jump	move
cakewalk	accomplishment
largo	passage
convergence	series
treadmill	mill
canon	scripture
neuroscience	neurobiology
prohibition	law
legalize	permit
courtesy	manner
bullock	cattle
chloride	halide
torpedo	alarm
stale	make
foul	hit
rebate	discount
accession	record
zhou	dynasty
crack	hit
monsoon	rain
urologist	specialist
oregonian	american
multiplicity	magnitude
neglect	decline
bark	noise
mechanism	performance
claw	scratch
headway	progress
quintet	set
participant	associate
heel	follow
paddle	bat
stand	put
faucet	regulator
run	accompany
sequoia	cypress
mistress	woman
bran	chaff
drop	fall
brine	solution
xylene	solvent
compliment	praise
han	dynasty
arcade	structure
swear	declare
consist	be
race	contest
smut	mold
consortium	association
ethnic	person
hakim	muslim
mezzanine	floor
divide	disagreement
expose	abandon
impersonate	act
status	state
complication	disease
bungee	rope
argumentation	reason
please	satisfy
broad	woman
siamese	intake
prodigal	consumer
shelter	structure
toner	material
bottleneck	narrow
causality	relation
call	telecommunicate
address	direction
mat	mount
brake	restraint
believe	accept
get	annoy
pasta	dish
annoyance	anger
do	proceed
strengthen	transformation
dusk	darken
intersection	set
mate	singleton
shoot	expert
bath	washup
deride	mock
balance	match
toe	hit
eradication	destruction
crowd	gather
oilseed	seed
sill	rock
tout	scalper
keepsake	object
coordination	classification
compost	composition
wheel	helm
bow	decoration
condense	remove
completeness	logicality
darkness	scene
spray	scatter
open	motion
slow	weaken
ginger	herb
waterproof	protection
fifth	interval
operation	process
syndicate	form
squeeze	compression
browser	spectator
jelly	conserve
motivate	cause
shock	gather
review	proceed
coil	transformer
tory	rightist
cripple	weaken
throat	open
chip	droppings
shunt	passage
perfection	state
crotch	angle
knock	rap
assay	analyze
goalkeeper	position
lego	plaything
shoot	measure
leather	flog
mold	hallmark
architect	creator
suspect	guess
fleece	fabric
ferment	inflame
sauce	change
underworld	class
backwater	region
focus	concentration
crush	break
top	garnish
design	create
drizzle	rain
impress	seizure
service	company
afflict	damage
courage	spirit
cascade	waterfall
bead	jewelry
washingtonian	american
clerk	work
tart	pie
hash	chop
franchise	concession
manifestation	indication
light	device
strap	tie
tank	vessel
tunnel	passageway
dedicate	give
concoction	mix
bop	dance
genomics	genetics
act	performance
confusion	embarrassment
airliner	airplane
vowel	phone
obedience	submission
instill	insert
gallop	pace
sever	separate
ping	reach
plant	organism
draw	write
nation	confederation
bargain	purchase
partnership	contract
erupt	appear
dominion	state
rule	direction
civilization	society
path	way
forger	deceiver
eight	digit
solidarity	commonality
hug	touch
program	announcement
peregrine	falcon
accord	give
ala	wing
orphan	deprive
radical	character
typist	employee
silence	condition
joker	article
plaster	cover
sponge	erase
wind	injury
overlap	concurrence
tampax	tampon
felony	crime
practice	implementation
marsupial	metatherian
rend	tear
word	language
clamp	inflict
utter	organism
ghost	soul
syringe	spray
spar	equip
escalation	increase
holder	owner
dissertation	treatise
balkan	european
hardware	component
grow	cultivate
man	staff
apache	gangster
bustle	move
outrun	run
roll	turn
eye	look
fruition	use
rally	feat
burden	concern
cruelty	maltreatment
nightgown	nightwear
budget	fund
orbit	path
yoke	support
see	receive
sleeper	furniture
fuse	equip
presumption	discourtesy
draw	remove
collage	collection
town	municipality
greet	address
intonation	prosody
motivation	condition
efficacy	effectiveness
yoke	connection
impression	portrayal
curtailment	shortness
music	punishment
relate	tell
godson	godchild
configuration	design
cornish	brythonic
earth	hide
underboss	assistant
qualify	remember
whisk	broom
frankness	communicativeness
mouse	person
mind	cognition
equate	equal
challenge	question
research	investigation
error	failure
cosmopolitan	sophisticate
trio	set
nod	gesture
mast	spar
fuse	light
axis	stalk
inconsistency	nonuniformity
crunch	noise
brunch	meal
consumerism	campaign
proximity	vicinity
chisel	carve
jitterbug	dance
spur	prod
fire	fuel
wrath	fury
sin	transgression
fortune	treasure
lamb	green
reason	fact
arm	supply
materiel	equipment
march	walk
grind	noise
expedite	action
catastrophe	adversity
condense	change
redemption	rescue
tortilla	pancake
compose	make
invite	interact
seduction	enticement
phosphate	salt
least	matter
glorification	adoration
orphan	child
call	order
mouth	feign
specification	description
deflator	factor
pant	noise
brand	tag
matron	woman
design	gestate
skinhead	bully
chadian	african
reprieve	warrant
muzzle	equip
history	continuum
flank	subfigure
station	move
succession	order
read	datum
suture	seam
beak	tip
racket	enterprise
force	compel
grain	atom
hutu	bantu
trident	spear
kingdom	domain
sling	move
capture	acquire
shang	dynasty
hope	person
thicken	material
toast	honor
push	urge
reduce	de-emphasize
tax	levy
thuggery	crime
diffusion	spread
declare	authorize
pick	device
large	size
oriental	asian
calvary	affliction
crepe	paper
date	stamp
frenchman	european
hurdle	barrier
forgiveness	kindness
sagebrush	subshrub
double	bid
shape	concretism
inside	region
approach	conceptualization
meditation	contemplation
astronaut	traveler
refuge	shelter
speck	spot
simulation	technique
insure	protect
forge	furnace
heighten	increase
obscure	change
hawaiian	oceanic
volley	hit
answer	statement
nightgown	lingerie
barrier	obstruction
immunity	condition
amortization	payment
brother	friend
breakage	reimbursement
spoon	cutlery
wrap	cover
label	description
rib	support
vulnerability	weakness
exposure	influence
expel	move
adonis	daemon
fun	activity
lentil	legume
sport	occupation
olympian	athlete
dizzy	change
tank	drink
clarification	interpretation
pinnacle	surmount
claw	make
voice	pronounce
union	organization
ream	enlarge
reinforce	teach
buckle	fasten
resultant	degree
malian	african
cafe	restaurant
pottery	workshop
essence	substance
blizzard	storm
complete	fill
blackberry	drupelet
centrist	adult
catch	perceive
play	diversion
relegation	categorization
paganism	religion
simulcast	broadcast
beat	strike
fijian	oceanic
decency	propriety
levant	abscond
pique	fabric
newscaster	announcer
profile	chart
anise	flavorer
dial	control
fatwa	opinion
hate	dislike
plate	illustration
concern	interest
yuma	hokan
cloister	surround
drag	tediousness
skyscraper	build
whip	instrument
germanium	semiconductor
negligence	carelessness
lift	change
gate	restrict
assault	attack
expose	subject
socialize	interact
oar	implement
bongo	drum
tear	drop
blinker	light
check	obstruct
suck	consumption
anguish	distress
train	activity
abdication	resignation
mace	staff
go	be
settle	change
engage	touch
lubricant	substance
set	stage
arrow	projectile
anchor	hook
settler	negotiator
instrument	device
bong	resound
return	arrival
transfer	travel
discovery	act
headdress	clothe
bolshevik	radical
lengthen	increase
sneak	walk
garlic	flavorer
back	confirm
section	slice
davenport	convertible
irreverence	evil
represent	re-create
centipede	arthropod
pompadour	hairdo
architecture	profession
lead	advantage
halter	hang
review	exercise
passerby	pedestrian
discovery	insight
toggle	supply
transmission	send
retailer	merchant
sop	concession
acclaim	applaud
study	memorizer
collegian	student
accommodation	settlement
spot	marker
whittle	cut
increase	amount
fork	branch
hike	raise
divorce	separation
mailbox	box
peavey	lever
fortify	add
teaspoon	spoon
downsize	reduce
variation	change
prefect	administrator
trouble	pregnancy
jungle	location
vitamin	nutriment
finish	completion
keyboard	holder
technology	application
wan	sicken
sikh	disciple
hood	criminal
texture	musicality
clean	shopkeeper
sari	dress
group	unit
sidebar	consultation
device	instrumentality
differentiate	calculate
error	misconception
flutter	beat
mandarin	citrus
compression	shrink
restlessness	nervousness
aqueduct	conduit
keeper	defender
seine	fish
ritz	ostentation
shoulder	thrust
warhead	explosive
reclaim	recycle
first	honour
senegalese	african
button	badge
cheek	talk
creep	fear
brit	copepod
come	originate
distillate	liquid
repatriate	extradite
post	list
liberalize	change
frock	dress
jag	flap
negative	denial
endocrinologist	specialist
linguistics	science
accrue	increase
highness	aristocrat
soup	composition
gringo	foreigner
fibrillation	branch
treatment	care
child	person
accusation	assertion
reversal	turn
lean	put
bar	barrier
hindsight	understand
witness	perceiver
loon	idle
hex	spell
guide	leader
tibetan	himalayish
implementation	act
approval	acceptance
birthright	inheritance
recapture	take
get	seize
bankruptcy	insolvency
raise	bet
kale	crucifer
yugoslav	european
catch	acquire
fire	happen
spray	application
turn	travel
coup	success
deposition	ouster
alpha	letter
coptic	egyptian
fleet	collection
cyberpunk	writer
decency	respectability
rodeo	exhibition
colt	foal
teak	tree
villager	inhabitant
jockey	horse-race
shop	buy
neighbor	person
minion	dependant
slave	person
sweep	wipe
behave	hold
zone	structure
present	tense
sampler	embroidery
ascent	slope
recast	cast
flask	containerful
disturbance	disorder
train	ride
mixer	beverage
libertarian	philosopher
dentistry	medicine
tissue	paper
ebb	flow
virginal	harpsichord
kiss	touch
revolutionize	change
mouth	touch
sobriety	temperance
swarm	group
rethink	think
tarnish	stain
ritual	practice
rear	raise
score	record
science	discipline
dispose	determine
boiler	vessel
victorian	person
geek	performer
drinker	consumer
floor	surface
nexus	series
steam	cook
cable	telegram
expect	evaluate
humiliation	case
factor	number
fairway	site
recycle	use
passivity	inactiveness
cat	gossip
pest	animal
turn	senesce
correction	improvement
solution	set
convener	caller
specialist	doctor
bow	stroke
shatter	burst
treachery	dishonesty
calm	comfort
appreciation	understand
fingerprint	procedure
subjugation	relationship
levy	conscription
landscape	genre
hear	modality
funnel	move
kylie	boomerang
battery	artillery
screwdriver	cocktail
post	call
poison	substance
ford	traverse
augment	grow
caption	title
riddle	sift
green	vegetable
cameroonian	african
cause	act
sell	persuade
lander	spacecraft
riverbank	bank
capstone	stone
open	space
requiem	mass
washer	worker
casserole	dish
rationalization	simplification
house	dwell
lift	wave
hang	fit
draw	representation
pimple	acne
pilgrim	believer
initiate	cause
hoax	deceive
hay	fodder
devise	gift
overcast	sew
litter	strew
rig	formation
difference	change
lather	froth
dignity	pride
fame	repute
kern	supply
jettison	throw
hop	jump
rod	bacteria
rival	contestant
offset	make
inflammation	arousal
recycle	cycle
scandinavian	european
congolese	african
rub	touch
occult	conceal
inscription	write
principal	debt
italian	romance
mention	award
pollard	ruminant
tariff	tax
portray	represent
daniel	judge
discouragement	disapproval
removal	dismissal
mind	notice
good	change
reservation	agreement
freak	mutant
magazine	publisher
trial	contest
ship	conveyance
sepsis	infection
wine	drink
bible	handbook
snuff	char
lifeblood	blood
spank	beat
incline	low
gambler	adventurer
squeeze	movement
pittance	payment
slag	scum
cot	bed
nutrition	science
clog	fill
grasshopper	cocktail
nick	cut
inferior	follower
cost	reimbursement
holster	belt
double	hit
tact	consideration
endow	give
motor	agent
insight	understand
revisionist	communist
temperature	somesthesia
duplicity	deception
throw	propel
subpoena	serve
press	machine
truffle	fungus
flemish	dutch
block	anesthetize
affiliate	associate
buoyancy	cheerfulness
tone	talk
aspirin	salicylate
miro	conifer
leave	faction
fire	combustion
plank	serve
lynch	murder
volume	measure
guide	orient
pi	letter
anger	emotion
top	region
usher	lead
overflow	flow
newspaper	paper
pathos	quality
proclaim	declare
verification	affidavit
duke	lord
waste	devolve
anesthesiology	medicine
gutter	run
dive	match
prize	gift
hook	implement
estimate	statement
shroud	cover
clog	coalesce
price	reward
revelation	insight
convertible	security
approve	evaluate
devastation	deterioration
rumble	seat
share	asset
decay	decrease
cross	voyage
kurdistan	rug
begin	talk
tom	black
cover	protect
waterline	line
nip	bite
sewage	waste
sprawl	spread
bride	participant
suffer	feel
condemn	denounce
multiply	calculate
count	include
menorah	candelabrum
geezer	man
retake	take
imperialism	control
lace	cord
luster	brightness
peck	strike
defy	elude
heavyweight	prizefighter
trail	path
set	exercise
drum	vessel
draw	run
bacillus	eubacteria
electrocution	kill
constituent	voter
symptom	indication
check	draw
approach	address
assumption	miracle
drive	power
bromide	halide
highland	scot
counterweight	oppose
scallop	bivalve
surmise	deduce
tee	connect
halt	disable
referee	official
subcontract	hire
lifesaving	rescue
flip	react
autograph	write
superhighway	network
genesis	begin
ask	request
connect	join
saran	thermoplastic
horst	crust
negativity	amount
motion	state
strain	tighten
loyalist	supporter
dowdy	pastry
intrigue	plot
chess	brome
sterilization	operation
bugle	bead
overhaul	care
commune	communicate
exhaustion	fatigue
make	be
ping	hit
solidity	dependability
stick	limb
resolution	remission
topic	content
oktoberfest	lager
wipe	rub
view	analyze
taste	exteroception
ripple	flow
hinge	joint
youth	youngness
order	rule
contain	be
internment	captivity
siege	blockade
manipulate	interact
cramp	suffer
draw	steep
summation	summary
composition	mixture
spin	revolve
layer	shape
give	make
induce	effect
dagger	character
inhabit	be
bench	remove
pitch	set
slap	blow
conjure	magic
reprisal	retaliation
emptiness	condition
food	substance
voodoo	hex
sacrifice	release
shrug	gesture
tau	letter
warpath	way
rehabilitate	reinstate
tease	ridicule
elimination	removal
grip	seize
end	destroy
nourishment	care
jam	interrupt
spill	move
relay	communicate
goose	pump
frisbee	disk
variation	theme
drawback	disadvantage
galley	vessel
verify	confirm
thatch	roof
bifurcation	furcation
rocker	trough
array	clothe
feast	host
subordinate	low
spiritualism	belief
extend	increase
rust	fungus
walk	compel
rod	implement
gelatin	dainty
sixth	rank
gull	deceive
trio	gather
puppy	dog
storm	disturbance
freeze	withhold
low	move
standardization	condition
slippage	decline
advent	arrival
juggle	cheat
air	dry
argus	giant
distress	pain
wealth	property
hog	lamb
hour	distance
prepare	educate
impress	affect
default	loss
serve	spend
metropolitan	archbishop
folk	kin
lunch	eat
screech	noise
try	pain
act	perform
lyricist	writer
equal	change
cappuccino	coffee
transformation	change
characteristic	quality
thigh	limb
lebanese	asian
yawn	breathe
slime	dirty
alpaca	wool
student	enrollee
salt	preserve
leverage	advantage
mane	hair
tourney	contend
centerpiece	decoration
associate	think
present	introduce
rotisserie	oven
swamp	flood
mascara	makeup
shade	semidarkness
oust	supplant
religiosity	devoutness
terminal	station
enrichment	improvement
animosity	hostility
second	attendant
profess	claim
figure	impression
representation	statement
wait	work
labor	undergo
grove	garden
plant	farm
wrap	crash
exponent	intellectual
scalp	sell
bun	bread
assassinate	defame
counterpoint	compose
huntress	hunter
eraser	implement
tinker	itinerant
focus	point
propane	gas
reduce	simplify
overflight	flight
form	become
give	lead
upgrade	good
leave	produce
subtract	calculate
europe	collection
heave	throw
hairdressing	toiletry
lawsuit	proceed
hunt	oscillate
hook	steal
humor	quality
mask	disguise
caucus	meet
romance	lie
speedometer	meter
prime	number
tread	contact
walk	travel
cleanup	position
devolution	delegate
judge	decide
steamer	travel
patriarch	man
outrage	atrocity
worry	rub
harrow	cultivator
penetration	attack
draw	represent
show	race
trumpet	proclaim
stifle	suppress
salt	flavorer
blame	reproach
softness	indulgence
dune	ridge
timidity	fearfulness
suggest	imply
hoe	tool
brick	ceramic
beam	piece
sling	throw
variance	dispensation
make	guarantee
sanguine	red
deal	result
tone	sound
prowl	walk
kennel	shelter
lurch	motion
comfort	support
swedish	scandinavian
lullaby	song
film	medium
chock	fasten
imagination	creativity
kashmiri	indian
observer	expert
lace	liquor
brace	rope
chase	frame
roll	change
safeguard	escort
governor	control
mutiny	rebellion
brassiere	undergarment
box	area
telecast	broadcast
grind	connect
lady	fuchsia
commonwealth	state
roll	move
cell	room
compile	make
confront	front
rub	guide
optometrist	specialist
portuguese	romance
seine	fishnet
step	locomotion
impregnate	inseminate
stripe	mark
brown	cook
crowbar	lever
accident	mishap
surmount	head
bravo	cheer
slack	idle
sac	cavity
base	electrode
manor	estate
leader	person
thing	situation
glimpse	see
trip	step
buffet	hit
thwart	prevent
stravinsky	music
brink	boundary
bask	lie
dream	perceive
ride	float
touch	manage
shorten	decrease
rendition	persecution
misinterpretation	interpretation
back	position
break	disperse
wean	estrange
scat	leave
point	mark
saddle	cut
deluge	fill
polemic	controversy
rocket	rise
choke	disorder
minimalist	artist
upright	piano
press	push
buildup	promotion
ewe	african
exert	act
lash	fastener
humanitarianism	doctrine
coward	person
balcony	structure
citizen	national
tunnel	penetrate
automobile	travel
corollary	consequence
bavarian	german
butane	gas
bogey	shoot
roe	egg
broth	soup
gait	locomotion
blogger	person
graft	join
oglala	siouan
rest	recumb
hack	horse
last	activity
sandbag	hit
settle	stabilize
education	upbringing
distribution	act
hajji	iraqi
sunburn	erythema
salaam	salute
surround	touch
offload	transfer
slush	water
attraction	quality
undertone	shade
rush	outburst
willingness	disposition
sin	transgress
diarrhea	symptom
backstop	fence
spell	alternate
bracket	edit
spike	develop
scandal	gossip
tongue	lick
rider	traveler
pop	throw
jumper	athlete
lap	sphere
chuck	throw
shipwreck	fail
regurgitate	fee
conspire	plot
charge	rush
nazism	fascism
judgment	act
ditty	song
node	computer
value	duration
ensign	color
colleen	girl
almanac	annual
corn	grain
stock	provision
tiller	lever
trench	fortify
chassis	skeleton
zionist	jew
shallow	change
convey	transfer
ease	travel
cocoon	retreat
feign	misrepresent
gleam	flash
destabilize	change
give	execute
proliferation	growth
wax	cover
corner	intersection
unknown	region
mastery	domination
column	article
mudslide	landslide
triumph	exultation
arousal	wakefulness
absorb	blend
attache	specialist
thrower	person
wall	difficulty
morse	code
mountainside	slope
lift	dig
niche	condition
potency	power
shipper	company
kirk	church
reception	party
headhunter	recruiter
pontoon	float
sprinkle	wet
drift	wander
row	line
clap	gesticulate
doctor	scholar
line	formation
axis	line
proof	change
grind	hit
exorcism	supernaturalism
teardrop	drop
die	cube
confront	meet
wash	watercolor
lead	induce
patronize	support
abolitionist	reformer
cameo	anaglyph
pillbox	case
distribute	be
plate	containerful
dormitory	bedroom
bolt	move
abnormality	misbehavior
costume	attire
hairdo	hair
pad	fill
topography	geography
tube	supply
maya	amerind
photography	process
knuckle	press
entomology	zoology
leper	outcast
rack	fly
journal	book
impression	publication
endorse	sign
heave	lift
insert	section
apologist	advocate
disruption	disturbance
memoir	essay
complexion	tint
pant	utter
sour	spoilage
ewe	sheep
tuft	bunch
conduct	administration
estimate	calculate
don	gentleman
sediment	matter
allow	assign
tackle	lineman
troll	talk
eliminate	remove
membership	body
slack	neglect
complaint	cry
triple	multiply
brine	drench
life	experience
bias	partiality
undertow	inclination
fall	sin
refute	disown
sidewinder	rattlesnake
render	give
fuss	perturbation
dial	operate
artifact	whole
square	simpleton
dispenser	supplier
submersible	apparatus
acceleration	change
starve	suffer
groin	area
sponsorship	support
craftsman	creator
sanatorium	hospital
sprocket	roller
definition	distinctness
cheeseburger	hamburger
stroke	mark
tory	american
page	attendant
bachelor	man
perfume	groom
salamander	amphibian
lancer	cavalryman
destiny	happen
counselor	supervisor
proton	nucleon
give	think
marriage	union
pall	change
concentrate	think
wallflower	flower
cat	cattail
portage	track
collaborate	work
servant	worker
contraction	decrease
ferment	substance
haste	motion
vouch	summon
statistic	datum
shoot	hit
assign	evaluate
retina	membrane
bitter	taste
juggle	manage
restriction	restraint
convert	change
trade	sell
term	constituent
grey	clothe
bulb	stalk
line	insulation
kite	fly
czechoslovakian	european
protest	oppose
park	maneuver
linen	fabric
line	reinforce
advancement	development
charge	accuse
episode	happen
grasp	hold
igloo	hovel
tan	craftsman
reincarnation	embodiment
fang	bantu
hominid	primate
ability	cognition
gloss	explanation
jerk	weightlift
osage	dhegiha
dissenter	person
surface	ascend
regiment	delegate
harlequin	clown
carry	influence
lean	throw
complaint	objection
twentieth	rank
infection	illegality
roller	wave
flaunt	expose
registration	entrance
sleep	rest
collision	dispute
shudder	tremble
dip	dunk
accession	increase
castle	move
contemplation	consideration
traitor	criminal
attendance	company
way	artifact
chink	sound
khan	ruler
sparkle	be
arrears	indebtedness
lull	hush
quiz	examine
godfather	patron
kink	person
slate	cross-file
quarter	division
analysis	calculus
ma	mother
gap	open
rhythm	prosody
jack	ball
part	tune
completion	termination
valuation	price
square	adjust
harbor	keep
tornado	cyclone
playground	yard
beset	assail
ephedrine	bronchodilator
orphan	young
grist	grain
adjuster	investigator
plumb	quantify
pullback	withdrawal
marxist	advocate
thistle	weed
main	pipe
aggression	combat
luddite	workman
gradual	antiphon
whale	cetacean
serve	deliver
emphasis	importance
retainer	fee
work	activity
hose	garment
scrape	rub
wash	be
replication	repetition
trier	person
subscribe	buy
pickup	corrective
blackmailer	criminal
bondage	subjugation
touch	somatosense
pass	succeed
evacuate	excrete
fog	atmosphere
tunisian	african
wait	act
spacewalk	walk
oneida	iroquois
present	gift
business	concern
asthmatic	person
trail	track
windmill	mill
gloom	semidarkness
tier	rival
hammerhead	head
bog	wetland
propriety	demeanor
provide	give
anomaly	abnormality
contemplative	person
crystallize	solidify
vestibule	cavity
waste	use
symphony	sonata
shank	part
democrat	politician
damp	wetness
cutlery	tableware
pulse	legume
phrase	construction
combat	battle
julienne	cut
wilton	rug
sugarloaf	sugar
vicinity	section
potential	possibility
statesmanship	wisdom
wardrobe	furniture
arm	mobilization
mouthpiece	aperture
interlock	embrace
individuality	trait
yodel	cry
bootleg	produce
make	tidy
willow	tree
skip	bounce
plantation	estate
responsiveness	sensitivity
kaleidoscope	plaything
clone	copy
conspirator	criminal
disfigurement	appearance
sprawl	lie
exercise	effort
brim	fill
weather	decay
torturer	oppressor
timorese	asian
honeymoon	vacation
mayhem	crime
biochemist	chemist
soup	dope
chatter	talk
equipment	instrumentality
pro	argument
scramble	struggle
poll	survey
repatriate	citizen
loft	floor
division	separation
cotton	shrub
invest	spend
citizenry	group
view	purpose
naturalness	quality
slammer	close
pole	hold
topaz	quartz
polystyrene	styrene
seawater	water
stalker	hunter
nineteenth	rank
deference	courtesy
cap	limit
hamburger	sandwich
pocket	pouch
coloration	color
verdict	find
shell	house
bran	roughage
phalanx	crowd
outdo	beat
articulation	expression
overexposure	exposure
transpose	change
pervert	use
unearth	locate
quarry	production
churn	vessel
suspend	change
justify	confirm
rally	convalescence
patronize	interact
intercept	catch
calyx	coil
read	interpret
lie	be
eskimo	indian
riverbed	bed
modernism	practice
avalanche	happen
seek	movement
artist	creator
harmonize	change
date	determine
adapt	change
hold	continue
enunciation	articulation
couscous	dish
ouster	ejection
minimalist	conservative
moo	cry
lob	throw
expand	grow
orgasm	consummation
popper	cooker
jackpot	prize
slash	cut
enemy	adversary
drudge	laborer
way	share
chamberlain	steward
slant	bias
ferry	transportation
administration	justice
sprinkle	scatter
rack	gait
achiever	person
public	body
septet	gather
inquiry	investigation
wing	help
seder	supper
jog	nudge
volunteer	serviceman
yoke	oppression
dictate	read
nightlife	entertainment
pronunciation	speech
mast	pole
tolerance	attitude
clear	free
head	toilet
facility	artifact
validate	change
solve	understand
tambourine	drum
tunic	cloak
snake	wind
curtain	barrier
spin	rendition
pennant	flag
gag	joke
list	move
mozambican	african
rule	draw
drape	arrange
discretion	liberty
down	turn
barnacle	crustacean
trace	draw
remand	return
link	instruction
puller	mover
truss	hold
hypocrite	deceiver
trade	exchange
liability	possession
action	mechanism
crash	hurl
horseman	rider
ammunition	information
reload	load
toy	device
market	trade
wit	message
disapprove	evaluate
might	strength
slave	worker
admissibility	acceptability
survey	analyze
cripple	maim
halt	stop
fuzz	beard
portico	porch
hovercraft	craft
redistribute	spread
bind	hindrance
quirk	twist
democrat	advocate
hyperactivity	disorder
breach	open
confederate	accessory
sense	awareness
circle	ellipse
flour	dredge
commute	journey
coast	glide
cirrus	tendril
carry	compensate
health	wellbeing
lurch	travel
refine	purify
excommunication	banishment
idleness	inactivity
come	travel
flinch	move
intensify	increase
tumble	drop
bend	section
school	educate
embarrass	upset
pad	leaf
gadfly	fly
evert	turn
milk	draw
finish	taste
reminiscence	memory
counteroffensive	offense
haywire	wire
particle	body
reinterpretation	interpretation
ice	object
soak	impregnate
challenge	invite
line	fill
dissent	disagreement
fratricide	murderer
rectangle	parallelogram
duck	poultry
deliberation	thoughtfulness
insert	attach
spymaster	master
cultivate	fix
overdrive	action
trap	confine
materiality	quality
qualify	pronounce
disadvantage	liability
flap	wave
munition	arm
consume	destroy
jersey	knit
lecture	address
bolt	abandonment
overuse	use
stain	dye
trappist	monk
abundance	quantity
disintegrate	change
disinfectant	agent
darkroom	room
andromeda	shrub
mire	dirty
exhaust	system
bannister	barrier
calculator	machine
gulp	drink
trouble	difficulty
pass	juncture
notary	official
savory	dainty
source	facility
smear	rub
martini	cocktail
asp	viper
level	aim
satin	fabric
drag	pull
wrench	injury
midair	point
snake	weave
set	arrange
godspeed	success
caliphate	jurisdiction
exclusive	report
norwegian	european
flag	tail
backbone	connection
draw	finish
health	condition
hammer	striker
cover	concealment
repose	put
scale	leaf
deal	interchange
hindrance	difficulty
plaster	mixture
appraisal	classification
microcosm	model
girdle	incise
conversion	exchange
pipeline	pipe
boycott	ostracize
attest	show
bandit	thief
elegance	quality
fielder	cricketer
transact	interact
patrol	guard
digging	excavation
multiplex	cinema
picker	person
juggle	poise
call	instruction
expectation	belief
argyle	sock
fasten	join
headband	band
item	whole
inflexibility	rigidity
yoke	attach
journal	axle
van	car
continuum	time
wave	hairdo
revisionism	bolshevism
diary	write
lombard	european
handout	announcement
suffocation	kill
grail	aim
administration	management
wet	workman
infiltrator	intruder
creche	representation
tease	disentangle
mumble	utterance
audit	analyze
pull	side
letter	text
adaptation	alteration
ration	fare
guillotine	decapitate
churn	move
tutelage	teach
puddle	plant
progression	series
infamy	disrepute
core	bar
reject	refuse
bowl	throw
make	estimate
sling	hold
crown	coin
prediction	reason
beat	agitate
lightweight	boxer
slot	position
motion	change
page	utterance
decommission	recall
draw	create
scuttle	container
consistency	uniformity
deem	see
islamist	scholar
plaintiff	litigant
plead	apologize
pare	object
gravity	attraction
sock	hosiery
bathroom	room
enlistment	commitment
sturgeon	ganoid
wring	squash
constipation	symptom
sponge	wipe
babble	chatter
boogie	dance
track	bar
poultry	bird
attainment	arrival
ferment	seethe
reallocation	allotment
weatherman	meteorologist
clinch	settle
emigration	migration
sable	fur
mountaineer	climb
chicken	poultry
beat	sound
croquet	play
haze	harass
favor	advantage
boundary	extremity
verge	border
antagonize	act
fruition	condition
erode	decay
bathe	cleanse
ramp	climb
harness	control
wart	imperfection
bloat	swell
inability	cognition
project	communicate
trespass	tort
interview	interrogation
bug	defect
retire	tire
enlargement	state
brand	kind
head	formation
charge	heraldry
deviation	variation
flip	dive
criminologist	specialist
lacquer	decorate
coordinate	meet
course	series
dip	angle
force	influence
stop	knob
gurney	stretcher
belly	swell
dramatize	represent
button	fastener
witness	speaker
transpose	arrange
wrap	cloak
crew	man
deviation	erroneousness
vanilla	flavorer
breath	breeze
odometer	meter
strip	remove
producer	creator
toe	walk
rationalization	explanation
ship	vessel
kill	destruction
markup	direction
radiation	emission
spin	prolong
impala	antelope
survey	examination
chela	hindu
noise	trouble
ranch	farm
junket	trip
samaritan	israelite
pan	disparage
moor	plain
conga	dance
tree	plant
deflate	turn
walk	locomotion
burn	execute
bastard	offspring
achieve	succeed
happen	chance
citizenship	demeanor
concentration	attention
misfire	fail
emerald	green
gee	exclaim
deal	act
mural	paint
loaf	food
paddle	oar
mash	fee
thrush	candidiasis
pass	flight
farewell	acknowledgment
grape	vine
deforest	clear
planetarium	build
bat	blink
regret	miss
livery	care
size	magnitude
squat	be
slack	loosen
negotiation	activity
turnaround	preparation
coincide	coexist
feel	perceive
practice	use
girlfriend	woman
record	save
entertainer	person
ore	mineral
backseat	seat
action	work
supercomputer	mainframe
cleanse	groom
sabbatical	leave
giveaway	disclosure
pose	position
fulani	african
handout	charity
function	utility
cistern	tank
peculiarity	feature
nature	universe
hint	suggestion
northeast	location
volunteer	worker
date	companion
plant	collection
thirtieth	rank
sketch	draw
meringue	top
humanism	doctrine
staphylococcus	coccus
naturalist	biologist
shake	barrel
tarantula	spider
invite	arouse
gobble	cry
predecessor	precursor
smash	hit
chariot	carriage
trump	announce
giant	anomaly
modulate	adjust
glaze	polish
lunchroom	restaurant
pull	move
comparison	relation
deliver	throw
obstruction	maneuver
reprint	reproduce
regimen	plan
carpenter	work
wonder	astonishment
crow	cry
tip	mark
taste	sample
foot	walk
leapfrog	progress
flourish	gesture
intellectual	person
mosaic	transducer
vent	express
rebate	refund
rubric	rubify
motto	say
marrow	dainty
duck	dive
firm	business
retiree	nonworker
entrant	contestant
tic	twitch
resistance	action
front	sphere
shrubbery	vegetation
scallop	shape
childhood	immaturity
ring	toroid
process	cognition
bolt	swallow
garden	vegetation
wreck	decline
seem	appear
bay	bark
presentation	ceremony
native	person
egg	coat
follow	multitude
support	give
drop	sphere
backfire	explosion
lotion	remedy
account	profit
raise	move
angelica	flavorer
bristle	react
console	bracket
pleasure	feel
caster	worker
extension	property
nutshell	shell
armenian	indo-european
reverence	respect
wahoo	mackerel
barley	cereal
angle	fish
isotope	atom
regular	follower
overtone	harmonic
bailiwick	jurisdiction
obscure	reduce
alphabet	script
hoof	dance
heel	bottom
secretary	assistant
reverberate	reflect
pit	remove
vindicate	acquit
backseat	inferiority
death	kill
mccarthyism	witch-hunt
bastille	jail
plurality	state
trust	trait
pill	thing
cave	hollow
decree	act
budget	plan
throw	propulsion
breeder	stockman
sunscreen	cream
risk	try
light	position
graft	attachment
dietary	fare
capitulate	surrender
propose	declare
choke	enrich
mineral	material
rehearse	perform
alaskan	american
albatross	hindrance
penny	coin
gainer	person
inject	administer
pink	sound
reimbursement	compensation
yuppie	professional
infestation	swarm
implement	instrumentality
winch	pull
roller	cylinder
mine	defense
extrapolate	deduce
teach	doctrine
suburbia	subculture
foster	rear
stage	initiate
stretch	widen
pensioner	beneficiary
entree	right
mayoralty	position
swiss	nation
chard	beet
read	understand
beware	watch
consul	diplomat
rumor	gossip
vice	transgression
disappearance	departure
network	system
assert	behave
lunch	fee
filament	wire
counterterrorism	scheme
chain	restraint
correction	edit
meld	announce
cornfield	grainfield
face	line
understatement	statement
momentum	force
weaken	change
mastectomy	ablation
warbler	singer
depress	discourage
bucket	put
stamp	die
famine	calamity
imitation	doctrine
court	area
form	change
sacrifice	offer
chorus	line
confessional	booth
annals	journal
trim	be
baptism	sacrament
rain	precipitation
atmosphere	condition
end	lineman
froth	exude
principal	educator
consideration	think
ball	baseball
surrender	give
late	news
drive	transportation
arise	become
gorge	ravine
point	end
stratus	cloud
fireproof	proof
cliffhanger	contest
balloon	fly
cherokee	iroquois
mirror	depict
rafter	supply
like	feel
suction	evacuate
club	symptom
interrogate	ask
macintosh	raincoat
porcupine	rodent
intertwine	twist
reprieve	postpone
subordination	submissiveness
boomerang	projectile
player	participant
horoscope	prediction
soften	change
offspring	relative
invasion	penetration
tie	fashion
round	tool
act	serve
boss	leader
crop	cut
tank	containerful
plantation	colony
burgundy	wine
sectional	furniture
hustler	opportunist
bobbin	winder
leech	follower
age	property
shunt	implant
absent	disappear
priest	clergyman
color	interest
advantage	point
cannibalism	practice
find	collection
avarice	greed
recorder	equipment
vocabulary	wordbook
heterosexual	person
inadequacy	unsatisfactoriness
deletion	mutation
anglican	protestant
work	energy
slip	escape
painter	artist
sweetheart	lover
bolivia	canasta
gore	blood
position	role
activity	act
visit	meet
bloodshed	murder
model	re-create
amount	magnitude
draft	depth
come	rank
litigant	party
orchestrate	score
lunch	meal
fold	structure
bless	raise
grenade	bomb
thing	entity
villain	character
tribesman	member
frame	enclose
tug	pull
pickpocket	thief
keg	containerful
chew	morsel
solidity	consistency
dream	imagination
compassion	sympathy
maverick	calf
providence	prudence
corner	area
purpose	decide
hustle	persuade
scroll	manuscript
scale	cover
bottleneck	part
cage	net
tag	label
stupid	simpleton
enjoyment	activity
motorboat	boat
catch	adult
dry	change
irritation	abnormality
bubble	emit
deck	platform
renegade	deserter
defeat	failure
changer	person
rosebud	girl
gruel	porridge
sick	person
brush	remove
reach	move
base	compound
personification	trope
plumb	trade
orientation	attitude
twin	grow
millstone	stone
stump	campaign
exuberance	joy
transsexual	anomaly
margarine	spread
grapple	seize
swell	increase
squall	blow
womanhood	adulthood
earache	ache
walker	framework
pylon	tower
excite	change
drive	steer
date	day
source	inspiration
macaroni	dandy
obliterate	blur
magazine	product
clarify	change
group	abstraction
swell	expand
belt	loop
hush	suppress
proof	impression
boardwalk	walk
stalk	gait
cast	fish
class	person
award	symbol
finish	happen
frieze	fabric
inca	ruler
thumb	cover
prince	aristocrat
cuff	lap
mail	collection
import	commodity
boatman	worker
create	make
payroll	department
masse	stroke
lope	run
saguaro	cactus
yankee	american
eccentricity	ratio
recall	take
transpire	evaporate
curse	profanity
exploit	use
culminate	end
frail	basket
bridesmaid	attendant
crochet	loop
drake	duck
jug	containerful
cachet	award
caress	stroke
endanger	exist
dinka	nilotic
dollhouse	plaything
ray	emit
drum	sound
alcove	recess
workload	employment
child	descendant
none	service
adverb	modifier
shackle	bar
hound	herb
crop	collection
sigh	breathe
blip	shock
gallop	ride
check	obstruction
coke	cocaine
pad	artifact
challenge	objection
extremist	radical
gazette	print
invalidate	negate
ice	diamond
communist	socialist
stalker	pedestrian
line	road
thrash	defeat
manifesto	declaration
reset	set
bounce	refuse
libel	defame
turnpike	gate
transplant	displace
sign	put
potash	lye
adoration	worship
agronomist	expert
amplitude	shift
cherry	drupe
minder	escort
bomber	airplane
section	class
flirt	play
giant	enterprise
condition	teach
ting	sound
attack	contend
presentation	inform
vicuna	fabric
flush	glow
mourn	observe
pitch	gradient
sponsor	support
administer	manage
root	grow
steal	move
yam	tuber
astrology	pseudoscience
gauntlet	glove
fountain	flow
chinchilla	fur
ridge	beam
adventist	christian
terror	coercion
center	place
remainder	part
chestnut	tree
revivalism	evangelicalism
probate	certificate
move	live
calamity	misfortune
tremor	shake
cost	outgo
dedication	fidelity
cattle	bovine
wire	conductor
mess	eat
alternation	succession
combustion	tumult
average	ratio
bottom	region
source	document
grind	surface
heel	part
marble	sculpture
stall	compartment
rollback	offense
dose	process
mussel	shellfish
score	set
narrow	strait
inhibition	abstinence
branch	stalk
certify	guarantee
roe	spawn
memory	faculty
screamer	headline
sizzle	sear
brand	marker
balsam	oleoresin
diagnose	analyze
mesh	relate
mammy	nanny
unionize	join
anatomy	analysis
keel	beam
retro	fashion
regurgitate	repeat
bull	man
gnat	mosquito
wagoner	driver
thunderstorm	storm
follicle	vesicle
procrastination	delay
arm	limb
shear	cut
mission	assignment
complacency	satisfaction
treasury	fund
oppression	subjugation
leave	turn
populace	person
dull	change
counterpart	equivalent
lithograph	duplicator
day	opportunity
smoke	aerosol
take	interpret
veto	vote
worry	mind
salute	greet
guard	device
spiral	wind
collar	neckpiece
esophagus	passage
letter	earn
orchestration	arrangement
process	manage
hook	hit
gray	radiobiologist
turn	movement
rarity	scarcity
gargoyle	decoration
fair	gather
prostaglandin	autacoid
siphon	organ
bottle	vessel
commando	serviceman
stir	work
tavern	build
purge	acquit
eagle	emblem
postpone	delay
cover	dress
throat	passage
indian	amerindian
lick	stroke
hedge	enclose
alert	readiness
benefit	good
fullness	largeness
erosion	decline
drop	gravitation
fuse	liquefy
bastard	variation
conference	discussion
alley	street
landlady	landlord
infiltrate	pass
furnish	accessory
double	raise
footwear	cover
circle	travel
transition	change
flagship	thing
key	harmonize
influence	power
hiatus	piece
amplification	increase
strand	shore
restrict	control
echo	reflection
warn	tell
semitic	afroasiatic
armor	equip
splice	junction
spouse	relative
nature	trait
decide	determine
factor	study
drive	make
relevance	connection
hurdle	obstacle
seminar	conference
obstruction	hindrance
hand	pointer
grace	beneficence
open	area
delinquent	wrongdoer
drumbeat	advocacy
survival	continuance
pile	collection
amish	mennonite
slob	vulgarian
relieve	rid
omaha	dhegiha
biomass	mass
freudian	follower
pesticide	chemical
reinforce	strengthen
residual	payment
abrasion	wind
niche	place
gross	sum
till	work
wash	clean
sulfate	convert
punjabi	sanskrit
rattle	shake
imitate	reproduce
glaze	top
device	emblem
give	perform
playhouse	plaything
prime	adulthood
hay	season
part	environment
deliver	give
acclaim	approval
beachhead	accomplishment
broom	finish
concur	happen
patent	register
provincial	official
decapitation	kill
rattle	tail
bleed	treat
corn	callosity
constitutional	walk
mat	cover
simplification	explanation
feud	contend
forfeit	act
stave	equip
pantyhose	tights
merchandise	commodity
panic	terrify
basement	support
attitude	orientation
seaway	lane
include	add
signal	electricity
speak	support
mince	chop
corner	part
riddle	pierce
rack	seize
microfilm	film
inflow	flow
texture	quality
implosion	collapse
study	concentration
dona	title
ascend	change
knock	sound
break	become
bison	bovid
boson	particle
ben	mountain
dialogue	script
soapbox	crate
radiate	issue
indignation	anger
permit	accept
urn	vase
footprint	area
eject	expel
jar	put
leave	yield
watercolor	pigment
divergence	separation
trade	business
glass	glassware
ruin	build
genre	art
vogue	taste
run	enforce
passivity	submissiveness
shotgun	firearm
curse	affliction
immunotherapy	therapy
resonate	sound
nod	inclination
megahertz	rate
zodiac	region
informer	informant
friendliness	like
ad	promotion
slumber	dormancy
deceive	victimize
election	vote
appearance	quality
give	toast
quench	reduce
validate	authorize
orientation	self-awareness
fee	provide
senate	legislature
birch	tree
replacement	substitution
occupation	activity
anil	dye
accession	agreement
wheelbarrow	transport
toy	manipulate
cloud	suspicion
knock	blow
recorder	judge
disengagement	retreat
flake	form
grind	teach
cruise	travel
commend	entrust
mandate	order
sensationalism	message
aviation	industry
quest	chase
wealth	abundance
southeast	wind
trust	consortium
airstrip	airfield
bittersweet	vine
scribble	handwrite
run	liberty
standby	thing
inspiration	arousal
guilt	condition
agree	suit
cardiology	medicine
poise	hover
snake	glide
captain	leader
stuff	impregnate
caddie	serve
temper	elasticity
custom	practice
bring	change
gladden	rejoice
recruitment	accomplishment
specification	document
choke	breathe
substrate	stratum
vegetarian	eater
tome	book
foreigner	traveler
stagger	arrange
tamarin	marmoset
cool	coldness
header	brick
pack	encase
proportion	quotient
hear	proceed
dedication	message
success	attainment
oath	promise
rim	boundary
couch	bed
wax	application
get	make
drink	consume
trip	experience
stitch	sew
pakistani	asian
monoxide	oxide
samurai	warrior
justification	explanation
pad	stuff
weaken	transformation
monk	religious
raise	multiply
confederate	supporter
screen	display
malathion	insecticide
elm	wood
trill	pronounce
retain	remember
instruct	inform
choir	chorus
cyril	missionary
fawn	flat
formulation	compound
assurance	certainty
bootleg	sell
dichotomy	classification
round	habitude
shag	fabric
worsen	change
altar	table
sugar	sweeten
upload	transfer
midstream	center
check	inspection
shopper	agent
plume	adornment
fang	extremity
row	boat
florist	shop
understate	inform
friar	religious
pain	feel
lacquer	coat
callus	scar
slump	drop
offense	team
magnitude	property
gunfight	fight
sequence	series
copy	make
catch	change
stripper	worker
invest	install
airhead	bridgehead
aim	position
invitation	allure
devise	inheritance
bear	carnivore
dynamism	doctrine
misfit	anomaly
tab	strip
skid	board
alight	descend
object	constituent
change	dress
shoot	ache
start	begin
periwinkle	seasnail
challenge	demand
birthday	date
guinea	coin
julienne	soup
interlock	device
skid	glide
killer	difficulty
grain	smallness
creel	basket
answer	reaction
braille	transliterate
sinner	wrongdoer
purr	resonate
check	consign
clinch	noose
gunboat	boat
represent	describe
act	activity
plank	lumber
system	group
licorice	candy
spiral	curve
blind	darken
snap	motion
stream	run
hit	succeed
runway	chute
bay	talk
deductible	sum
course	direction
tomahawk	weapon
collector	worker
neuter	sterilization
oak	tree
floor	room
breakaway	secession
fight	controversy
drumstick	stick
realization	understand
slit	cut
loosen	alteration
swing	fornicate
come	become
paint	coat
kurd	asian
interrogation	question
clog	slow
deference	politeness
stucco	decorate
put	use
bureaucracy	organization
makeover	reconstruction
master	authority
dais	platform
outreach	reach
defile	pass
round	ammunition
clutter	disorderliness
guarantee	collateral
affinity	attraction
tablet	cake
work	mechanism
switch	flog
core	hollow
shark	wrongdoer
encapsulate	enclose
shill	deceive
hook	offer
enforce	compel
strut	gait
novelty	originality
parry	block
enlarge	increase
sled	sport
sofa	seat
parade	display
faroese	scandinavian
runner	device
entry	account
scarcity	insufficiency
start	line
pilot	trade
stall	stop
groom	fancify
renewal	repetition
sculpt	shape
drape	manner
historian	scholar
zany	clown
georgette	fabric
pine	conifer
derision	disrespect
authority	permission
shovel	containerful
recess	indent
podcast	circulate
sign	gesture
semantics	mean
spike	implement
formation	arrangement
balloon	flight
idolatry	worship
recapture	recovery
topsoil	soil
blast	fire
organic	fertilizer
import	foreigner
recoup	compensate
transform	change
amputee	unfortunate
tail	spy
dimple	mark
ersatz	substitute
negotiation	discussion
formaldehyde	gas
web	trap
retire	displace
pep	liveliness
city	municipality
compare	analyze
kill	hit
overthrow	depose
ricin	albumin
canister	container
stub	uproot
apparition	spirit
sign	communication
caveat	notice
freeze	change
disorganization	disturbance
align	adjust
clamor	express
legitimate	justify
clientele	person
exposure	presentation
chronicler	historian
railroad	supply
alien	transfer
coincidence	accident
hope	wish
repudiate	deny
vacation	leisure
aphrodisiac	stimulant
timothy	grass
sniff	inhale
terry	towel
recover	get
compose	calm
mouth	rima
biographer	writer
fratricide	murder
creep	diffuse
repeat	tell
beacon	lead
cowboy	performer
cramp	strip
tinderbox	box
bend	curve
privation	poverty
stubbornness	resoluteness
swim	be
receivership	position
cross	structure
wield	have
flea	ectoparasite
pothole	hole
bargain	agreement
tape	attach
scrutiny	look
failure	nonaccomplishment
insurgent	revolutionist
variable	thing
ambush	wait
make	develop
vanish	disappearance
reflection	picture
untouchable	outcast
aquaculture	cultivation
brim	have
panzer	tank
sidewinder	missile
plum	drupe
slipper	footwear
puree	rub
assign	distribute
rope	tie
pink	flower
communion	ritual
dissolution	termination
major	student
swish	sound
settle	bench
grasp	control
aspirant	applicant
levitation	rise
represent	serve
tie	beam
pool	group
reorientation	orientation
put	subject
risk	probability
grind	shape
demographic	statistic
bugle	herb
satirize	ridicule
coma	tuft
witness	experience
hiker	pedestrian
electrify	fill
successor	substitute
parent	genitor
spade	dig
modification	copy
restoration	model
estimate	respect
ninja	class
outfit	attire
open	ceremony
fund	support
juke	feint
alto	singer
demoralize	confuse
chlorine	gas
suppress	control
sorrow	sadness
define	show
yodel	sing
jew	person
choke	compress
unit	whole
creche	hospital
govern	citizenry
compromise	settle
action	state
flannel	fabric
body	mass
glow	light
precede	lie
butte	hill
endowment	capital
origin	begin
astrophysics	astronomy
cayenne	flavorer
pipe	decorate
aim	mean
outsource	source
spoiler	airfoil
bot	larva
excuse	defense
harmonize	compose
specificity	particularity
windward	direction
surgery	room
charge	debit
impact	contact
cycle	sport
carry	communicate
duck	score
medalist	winner
mutation	change
buzzword	nonsense
repertoire	collection
preparation	activity
ring	jewelry
illiteracy	ignorance
impersonate	mock
rogue	villain
fox	algonquian
dexterity	adeptness
three	digit
gentile	christian
rationality	sanity
ledger	record
eruption	emergence
value	determine
head	top
adieu	farewell
notation	write
goad	stab
bladder	bag
withdrawal	separation
legality	lawfulness
chauvinist	patriot
beat	play
quiche	maya
fellowship	prize
sellout	treachery
pitch	throw
hear	session
draw	poker
scourge	whip
generalization	colligation
vault	structure
highness	degree
care	repair
web	membrane
bazaar	marketplace
peat	humate
teaser	worker
beryl	mineral
ordinary	clergyman
amyloid	starch
sideline	line
convoy	escort
contribution	gift
stroke	row
injunction	prohibition
lory	parrot
theme	tune
declassification	decrease
adversity	misfortune
zimbabwean	african
mass	prayer
sublime	change
index	scale
bunt	smut
lurk	hide
drop	descend
catapult	engine
ruin	decay
horse	equine
newtonian	follower
pump	blast
constrictor	snake
blouse	top
keen	dirge
tighten	change
torment	pain
number	limit
feeder	branch
bump	hit
stilt	pole
attack	begin
rewrite	write
pass	transfer
infuriate	anger
siren	alarm
blister	vesicle
stomp	walk
up	increase
fresco	mural
splat	slat
prepay	pay
silo	tower
rye	cereal
flask	bottle
goatee	beard
gift	acquisition
misdirection	commission
gamble	try
lord	ennoble
daydream	idle
insubordination	defiance
heir	recipient
romeo	lover
czar	sovereign
tutorial	session
offside	mistake
redefine	specify
significance	importance
rate	stand
man	work
cordon	series
sleet	precipitate
spiral	rotation
relapse	revert
competitiveness	aggressiveness
regular	patron
buttress	strengthen
flop	descent
kick	blow
portage	carry
sultan	ruler
skylight	window
politician	schemer
indecisiveness	irresoluteness
fitness	condition
make	change
beat	stroke
vietnamese	mon-khmer
sandbox	mold
begin	happen
give	submit
clasp	seize
mafia	clique
submarine	attack
identity	recognition
chinese	asian
spokeswoman	spokesperson
strand	land
load	weight
guard	act
salvage	rescue
simulate	dissemble
addendum	matter
frisk	search
insulator	material
lama	priest
hotbed	bed
off	future
evasion	negligence
congregation	collection
habit	custom
burundian	african
prompt	inform
survey	calculate
paragraph	write
kayak	canoe
tug	fight
mention	remark
brimstone	sulfur
drop	express
cut	fall
wool	coat
prohibition	decree
distribution	space
impart	bring
dateline	line
taxi	ride
herd	crowd
circumstance	condition
redskin	indian
dress	position
grey	discolor
fever	symptom
pulley	machine
guard	lineman
deliver	talk
westernization	assimilation
moment	time
deplore	complain
senility	oldness
militarist	adult
purse	bag
scot	european
indiana	artist
halve	divide
multimedia	transmission
layer	structure
squirrel	fur
calculate	evaluate
linden	tree
fistfight	fight
kaiser	emperor
pile	thread
caster	shaker
vitriol	attack
fullback	back
rock	move
aspect	characteristic
say	express
hatchet	ax
drama	episode
slander	defamation
reserve	request
screw	propeller
knighthood	nobility
behalf	sake
joint	junction
humble	change
harbor	hide
plug	blockage
gal	girl
retrain	train
mentor	intellectual
blank	prevent
measure	container
glory	beauty
differentiate	develop
hideaway	area
peeler	device
repair	condition
lament	complaint
information	cognition
retire	discard
censure	disapprobation
harden	change
zoom	travel
steep	concentrate
carnival	show
bullock	bull
load	handle
canal	supply
dominance	condition
lemon	relish
till	cultivation
beg	plead
sanitation	sanitariness
atlas	column
crimp	curl
close	fill
avenue	approach
proportionality	ratio
work	capture
ostracism	ejection
brace	strengthen
style	kind
stint	job
hopi	shoshone
macho	male
bully	attacker
ruffle	loosen
stockbroker	agent
jury	committee
flicker	shine
liquidate	settle
clown	comedian
foul	change
ignorance	content
anchorage	arrival
map	permute
pull	rein
take	act
stab	blow
neighbor	object
open	move
turner	person
endeavor	try
western	feature
smut	change
bulk	bulge
regular	soldier
couple	pair
veto	oppose
allotment	share
placental	mammal
peep	utter
diversify	change
ribbon	notion
readout	information
suture	sew
smut	fungus
cheyenne	algonquian
penetration	ability
sanction	authorization
diver	explorer
sisterhood	kinship
air	excursion
obstruct	hide
clear	remove
die	change
lighten	descent
biology	life
deliver	bring
hit	murder
mud	slander
soak	immerse
spatula	turner
bid	seek
disable	change
troll	praise
midfield	center
propagation	dissemination
ordeal	trial
greek	indo-european
taste	sensation
doe	placental
charger	device
represent	equal
refine	process
address	access
mischief	misbehavior
snafu	blunder
aggregate	sum
skin	strip
kimono	robe
capote	cloak
mellow	ripen
lozenge	candy
hind	grouper
unite	join
valentine	sweetheart
project	transmit
work	excavation
chap	crack
estate	property
provide	support
introduction	proposal
banish	expel
sentiment	feel
well	compartment
renovate	regenerate
bridge	structure
premium	bonus
blitz	attack
constriction	feel
grit	clench
southerner	american
steel	alloy
tweed	fabric
open	start
capote	greatcoat
grade	elevation
connection	relation
thyme	herb
journal	periodical
sow	circulate
malpractice	wrongdoing
seat	put
archery	sport
subcommittee	committee
belt	fabric
straddle	position
snort	utter
figure	maneuver
telecommunication	medium
cellist	musician
type	write
get	catch
ward	block
turtle	hunt
shoot	opportunity
dictate	principle
frost	cover
nature	type
spearhead	leader
assessment	charge
bob	dress
eclectic	philosopher
whack	sound
overload	load
shaman	priest
ornithologist	zoologist
equator	circle
flare	fire
cookie	cook
hood	attachment
high	elation
model	assistant
tinge	affect
drizzle	sprinkle
track	make
stall	booth
ornamental	plant
lease	get
madden	anger
endearment	kindness
exhumation	act
educate	good
time	attribute
fragility	vulnerability
macedonian	european
poacher	scorpaenoid
bottle	containerful
consultancy	practice
instruct	order
connect	relate
start	turn
clear	rid
pepsi	cola
bomber	sandwich
initiate	admit
quill	rib
absence	seizure
liberate	free
model	shape
dominique	chicken
cypress	conifer
romanov	royalty
now	present
trojan	asian
decrease	change
indulgence	permissiveness
straddle	motion
prey	exploit
actress	actor
literacy	skill
service	tableware
honesty	herb
reinterpret	interpret
kill	veto
purgatory	situation
unpredictability	uncertainty
ditch	crash
bracket	set
wafer	paste
splice	join
bisexual	sensualist
hose	water
politeness	courtesy
stuff	object
barricade	barrier
reside	populate
whack	hit
novel	book
menthol	lotion
custom	survival
resell	sell
profession	avowal
shepherd	tend
surgeon	doctor
serve	work
relocate	move
fly	transport
host	patron
platform	structure
detention	confinement
steer	control
candy	sweet
firewall	wall
asp	cobra
doubt	disbelieve
vote	body
belong	be
lunge	stab
face	front
borrow	get
plankton	organism
rub	representation
abort	die
asphalt	pave
shelve	put
custard	dish
grind	connection
scallop	shellfish
exhaust	waste
head	structure
kudzu	vine
tapestry	hang
thrift	subshrub
diet	legislature
redeem	cash
mallet	hammer
pacifism	belief
begin	achieve
spinach	green
girl	woman
jab	gesture
release	pass
furnish	supply
dub	soundtrack
cauliflower	crucifer
census	count
vote	choose
communicate	interact
crockery	tableware
carnival	festival
compromise	queer
give	elasticity
add	increase
burn	waste
associate	accompaniment
claw	seize
receive	accept
climb	progress
tick	mattress
motif	design
lobster	shellfish
complement	balance
carpet	cover
dock	enclosure
capsule	container
splurge	flaunt
ray	elasmobranch
initiation	begin
cube	cut
upset	tool
mumble	chew
sortie	flight
head	object
blockade	obstruct
sputnik	satellite
badge	emblem
keep	protect
trace	indication
shimmy	dance
plenty	abundance
deadline	point
frontal	curtain
term	point
flush	run
voluntary	solo
reminder	message
bunny	rabbit
yak	communicate
dash	run
curbside	pavement
smallness	size
cuckoo	repeat
twill	fabric
key	kilogram
spontaneity	naturalness
air	quality
copy	material
organize	manage
kneel	rest
jag	cut
toss	agitate
serve	effect
slight	dismiss
consistency	coherence
jetliner	jet
brotherhood	class
reluctance	unwillingness
sprig	decoration
relax	loosen
shortness	lack
architecture	build
build	develop
footprint	mark
iris	diaphragm
spine	process
apprehension	expectation
desert	biome
card	correspondence
maneuverability	mobility
carve	shape
adviser	authority
scale	size
device	design
raccoon	procyonid
lengthen	grow
ease	naturalness
breathe	be
masturbate	stimulate
sima	rock
santee	siouan
diaper	garment
insure	person
sun	expose
hamster	rodent
plague	calamity
photographer	artist
haven	shelter
breeze	travel
tag	name
acoustic	physic
paranoia	psychosis
round	partsong
thud	sound
wingman	pilot
spike	banish
ball	wind
interest	arouse
need	condition
race	sport
automation	condition
devotion	love
galvanize	shock
davenport	desk
luddite	adversary
likeness	picture
instrument	equip
shake	move
run	score
ship	hire
kuwaiti	asian
transcribe	rewrite
sin	letter
pipe	tube
supplement	add
pop	sound
caller	speaker
deputy	agent
downgrade	grade
closeup	photograph
give	happen
hang	decorate
structure	organize
lattice	framework
brace	hold
tang	dynasty
digger	laborer
neutralization	destruction
exclaim	express
account	system
mud	soil
board	use
gunman	shoot
deny	withhold
fishery	workplace
grow	production
turkey	poultry
deposit	guarantee
average	calculate
trim	attitude
storeroom	room
run	trade
acorn	fruit
subject	affect
anoint	choose
detection	discovery
buff	implement
synchronize	align
cardboard	paper
stud	man
moderation	decrease
continuance	activity
erase	delete
right	interest
lock	overwhelm
retribution	correction
sourdough	leaven
fishbowl	aquarium
boarder	intruder
ombudsman	investigator
open	succession
prime	fill
perpendicular	gothic
contact	connection
chastity	abstinence
bolo	knife
wick	cord
inversion	motion
subside	dip
promenade	march
barge	boat
batch	collection
guess	estimate
bazooka	launcher
spike	nail
utility	facility
imperative	duty
jack	tool
romantic	idealist
dominion	dominance
showroom	panopticon
fracture	pervert
yin	principle
crust	discourtesy
convict	wrongdoer
stabilize	change
decoy	entice
swordfish	scombroid
excellence	quality
interact	act
ginger	zest
congress	meet
wildness	intractability
trace	line
recognize	remember
extra	artifact
rake	sweep
stratification	categorization
pitcher	vessel
flashback	transition
chromosome	body
romanian	romance
bell	curve
quicksand	pit
recommend	propose
facade	front
oncology	medicine
scatter	sow
electrolyte	solution
zen	buddhism
conversion	calculation
rate	measure
compound	whole
angelica	herb
arouse	make
communist	politician
bayonet	knife
lap	thigh
one	unit
whore	fornicate
paternity	state
range	facility
aggregate	come
martyr	kill
date	present
slouch	carriage
medallion	coin
hopper	jumper
fixation	fasten
box	seat
flan	dessert
crucible	vessel
line	differentiation
hierarchy	organization
antique	change
carton	containerful
negotiate	pass
criticize	act
solo	perform
ice	crystal
complex	compound
salvo	outburst
pupa	insect
foreman	supervisor
couple	two
corset	dress
whiff	strikeout
occasion	business
poke	pierce
box	hit
aerosol	dispenser
withdrawal	retraction
section	write
obscurity	semidarkness
arson	burn
parka	jacket
mascot	organism
clockwork	mechanism
promote	support
house	shelter
sucker	shoot
witness	signer
allowance	license
mutuality	reciprocality
investment	promotion
id	instinct
sheraton	furniture
causeway	pave
ell	annex
wheelchair	chair
discredit	disparage
listen	concentrate
bind	fasten
iron	shackle
slugger	boxer
place	situate
sojourn	stay
moonlight	work
debt	indebtedness
turner	tumbler
fatality	death
paramilitary	force
indicator	signal
ionosphere	region
gutter	misfortune
needle	prickle
leak	hole
signature	tune
measure	maneuver
neutralize	weaken
geneva	gin
boyhood	childhood
romper	garment
crave	desire
ingenue	character
hint	indication
opinion	belief
face	surface
primate	placental
insignia	badge
stump	clear
blanket	cover
epilogue	conclusion
security	asset
rest	put
cry	change
press	be
tap	walk
concrete	solidify
frame	application
rear	side
withdrawal	indifference
film	wrap
acuity	sight
pest	tormentor
poise	put
mocha	leather
fraction	part
toll	levy
dimension	shape
drive	push
petite	size
extent	magnitude
school	build
tollbooth	booth
adobe	brick
grill	framework
freehold	estate
levitate	raise
merlot	vinifera
squash	vine
appointee	person
dissolve	liquefy
seed	remove
launch	propulsion
cocoa	foodstuff
hilltop	peak
abstraction	concept
compass	achieve
nationality	status
quack	doctor
trademark	marker
export	trade
muscle	authority
consequence	phenomenon
repress	change
horn	device
death	change
testimony	evidence
deregulation	liberation
neck	land
seventh	rank
haunt	pursue
fender	guard
comfort	condition
spice	change
shutter	blind
richness	fruitfulness
registration	certificate
pump	wield
replay	meet
slice	spatula
retrofit	install
calculus	rock
trilogy	trio
carry	continue
collector	electrode
fourth	interval
onlooker	spectator
number	designate
crutch	expedient
iniquity	condition
gourd	fruit
jurisprudence	philosophy
beater	implement
park	tract
decompression	decode
contrast	scope
judiciary	administration
reinvent	recreate
lemon	citrus
twin	crystal
executor	fiduciary
weekend	spend
identification	identity
foundry	factory
bear	have
gasoline	fuel
reduce	demote
positive	adverb
weave	design
lager	beer
mark	evaluation
moratorium	delay
form	word
simplicity	naivete
roadhouse	hostel
detoxification	treatment
mnemonic	device
pillar	principle
anticipate	happen
bow	play
rebound	catch
miscarriage	failure
layman	common
plea	answer
faze	upset
defeat	end
hook	entice
postage	token
break	invalidate
sign	validate
throw	movement
argument	value
pass	success
impropriety	demeanor
haydn	music
pendant	adornment
lecture	teach
silk	fabric
dynamism	activeness
implantation	placement
bunker	transfer
mellow	change
middleweight	prizefighter
shawnee	algonquian
campaign	venture
ballistics	dynamic
commission	command
tell	inform
govern	control
grind	throw
acetaminophen	analgesic
turn	activity
ear	hear
form	ability
carol	sing
caterer	supplier
stick	pierce
indiscretion	misbehavior
charge	aim
flounder	flatfish
feel	fabric
gammon	bacon
snooker	pool
upholstery	trade
jockey	manoeuver
mask	cover
lie	levy
impregnate	fill
newness	age
canvas	mat
escape	plant
transporter	crane
enjoy	experience
heckle	break
leaven	imponderable
rave	declamation
commemorate	observe
incident	happen
patchwork	theory
speak	communicate
gumbo	soup
wit	intelligence
conflict	opposition
sheet	fabric
snot	mucus
acrobat	athlete
dare	challenge
extent	degree
accept	react
concession	agreement
heartland	region
diamond	carbon
ember	fragment
coldness	unemotionality
report	inform
appointment	occupation
flare	erythroderma
ask	address
dissent	objection
rag	play
prevalence	ratio
brutality	atrocity
gynecologist	specialist
round	miscalculation
scan	move
press	clamp
visualize	watch
weather	lean
danger	area
powerhouse	team
narrowness	restriction
wiper	contact
critter	animal
perforation	hole
jelly	substance
musher	traveler
wren	passerine
disorientation	confusion
mint	plant
pilgrim	settler
codify	systematize
screen	fabric
ball	plaything
feasibility	practicability
endorsement	signature
tranquilizer	sedative-hypnotic
rearm	arm
entangle	involve
russian	slavic
center	lineman
trickle	run
celery	herb
monogram	symbol
booth	table
head	projection
planter	farmer
office	staff
place	race
russet	homespun
drift	change
commercialization	exploitation
rappel	descend
shear	snip
periwinkle	herb
navigator	explorer
answer	plead
stack	arrange
squint	look
stress	express
legislation	government
muskogee	muskhogean
emulation	technique
knock	criticism
enrich	add
work	go
heaviness	weight
abbey	church
wrangle	herd
product	quantity
proceed	travel
inflame	worsen
scan	search
counterattack	attack
mucus	secretion
gutter	provide
operation	transaction
retain	hold
lover	person
make	amount
yearling	placental
catch	object
part	thing
kick	waive
doorway	entrance
whoop	shout
check	change
bygone	past
porch	structure
inca	quechua
tempt	stimulate
brie	cheese
farmer	creator
favoritism	inclination
nonsense	message
wine	alcohol
inconvenience	discomfort
subterfuge	misrepresentation
treasure	collection
leach	remove
devastation	feel
splat	flatten
hack	edit
ordination	appointment
sacrifice	kill
uniformity	regularity
denouement	result
butter	cover
centerfold	foldout
bite	subtraction
despair	condition
release	device
slick	polish
commissary	shop
correction	rebuke
whiplash	injury
philanthropy	aid
chemical	material
baptize	name
negate	prove
serenade	perform
sol	colloid
paint	create
gentile	person
crawl	teem
remove	transfer
springbok	gazelle
flop	failure
game	occupation
humanitarian	benefactor
ply	join
adjournment	termination
approximate	resemble
head	proceed
gong	sound
debut	presentation
newsroom	staff
modern	person
zulu	african
hang	drop
break	end
blue	dye
attempt	activity
crack	cocaine
balsam	ointment
taste	sense
rush	act
inbreeding	couple
wiretap	investigation
diner	eater
shrink	decrease
sweeten	change
trickery	misrepresentation
clairvoyant	psychic
float	launch
loom	rise
satellite	air
shunt	conductor
spice	preservative
dope	change
reform	good
dead	time
sycamore	wood
purse	sum
opal	mineral
tai	kadai
franchise	business
remove	distance
read	have
tutor	relate
time	regulation
exorcist	sorcerer
want	search
quantification	measurement
endemic	disease
treatise	write
bump	dance
misfortune	trouble
condition	statement
talk	communicate
animate	stimulate
danish	scandinavian
condemn	declare
blade	leaf
spearmint	mint
picture	situation
violate	touch
bungle	act
blackout	unconsciousness
deepen	development
headline	advertise
catalogue	compose
raccoon	fur
buzz	sound
ape	imitate
rainmaker	executive
retaliate	strike
salve	medicate
blister	attack
buzz	summon
sink	anxiety
grace	gracefulness
horticulturist	expert
tow	draw
blockbuster	hit
consort	interact
ischemia	anemia
tapper	person
thousandth	rank
revolver	pistol
blank	sheet
tinderbox	situation
hear	perceive
snag	bulge
shakespearian	scholar
mistress	employer
modernization	adaptation
metro	railway
torch	light
excuse	forgive
day	life
link	fastener
flap	airfoil
loft	pitch
piggyback	haul
bodice	top
palindrome	word
trunk	stalk
examiner	inquirer
charge	claim
head	individual
graph	represent
general	head
shingle	signboard
popularize	circulate
break	discontinue
flaw	damage
key	explanation
watch	timepiece
analyze	treat
bliss	elation
buildup	accretion
posterity	generation
escapee	fugitive
tapper	worker
graduate	receive
obfuscation	blacken
chance	risk
ginseng	herb
romance	novel
muck	remove
deletion	edit
pulse	rate
interdiction	prohibition
junior	lowerclassman
swashbuckling	demeanor
formula	milk
plaster	surface
erection	structure
train	control
write	correspond
puller	worker
educate	polish
peroxide	bleach
honey	sweeten
predicate	relate
pathway	path
absorb	receive
fringe	edge
read	predict
fingerprint	mark
cone	bevel
mark	indication
attract	pull
pare	cut
race	group
compulsive	person
fugitive	person
nebula	formulation
rail	lie
intangible	asset
guarantee	back
roll	travel
fanaticism	intolerance
bind	adhere
alcohol	liquid
mint	candy
remission	suspension
softball	ball
naturalization	naturalness
cheese	food
marathon	footrace
kink	idea
paint	represent
serve	suffice
tuna	scombroid
leninism	communism
urgency	importance
chemist	scientist
bray	laugh
greenery	leaf
dime	coin
fitness	suitability
sheet	cover
declare	proclaim
behavior	activity
fence	contend
deck	decorate
breast	help
prodigy	genius
pyramid	swindle
screen	analyze
origin	ancestry
derivation	act
staple	nail
become	transform
rocket	herb
memorial	recognition
turn	change
pierce	penetrate
gripe	complain
output	produce
potter	busy
frog	adornment
reef	shrink
make	reach
toast	bread
pronouncement	declaration
jaundice	affect
stalk	pursue
mumble	talk
wool	fabric
revive	boom
perpetuity	permanence
fish	catch
bin	container
admiral	nymphalid
bag	pack
middle	put
bonnet	hat
signature	sheet
bug	microphone
derrick	crane
imp	child
stuff	quality
force	thrust
indoctrination	teach
market	shop
contingent	gather
allusion	mention
lorry	truck
genetics	biology
listen	perceive
postage	charge
slur	denote
clinch	fastener
apostasy	rejection
hop	dance
oneida	iroquoian
turbulence	disorder
nanny	woman
restaurant	build
path	line
tie	equal
protest	affirm
tithe	charge
statement	message
rough	site
trinity	godhead
inheritance	heredity
level	place
carve	sculpture
coldness	vasoconstrictor
unveil	uncover
protest	complain
enclosure	area
seat	center
hurrah	cheer
spy	watch
dispatch	kill
disguise	concealment
ute	shoshone
buttress	support
section	area
slurry	suspension
face	person
beep	call
admirer	person
mantle	layer
dead	person
host	organism
absolution	redemption
fluke	projection
explore	diagnose
fullback	play
fountain	structure
atrophy	shrivel
nighthawk	goatsucker
afterglow	pleasantness
rattle	noise
stuart	royalty
masquerade	pose
direct	order
retail	sell
contact	lens
bankroll	fund
homestead	settle
strangulation	constriction
thing	property
sandbox	plaything
paper	article
cult	religion
computer	machine
bank	array
urge	advocacy
stage	dramaturgy
coat	hair
group	meet
pet	caress
asbestos	amphibole
governess	teacher
bassist	musician
charity	benevolence
amino	group
tail	reverse
hernia	rupture
osteoarthritis	arthritis
corner	monopoly
displacement	rejection
jean	trouser
glassware	tableware
evangelism	sermon
salon	gallery
see	seat
confine	scope
bulk	magnitude
cut	dilution
consideration	kindness
twitch	spasm
bill	statement
distill	exude
cut	look
thread	extract
medium	liquid
caregiver	adult
radiate	emit
suffer	experience
spew	exhaust
lie	put
possibility	expectation
shine	work
iteration	process
spotlight	lamp
follow	travel
melamine	base
tetanus	infection
peacekeeper	defender
flare	shape
rate	tax
intelligence	information
patch	supply
flourish	embellishment
snobbery	arrogance
tree	elongate
station	series
corner	control
hit	propel
recognition	approval
coke	fuel
sieve	choose
ballot	vote
touch	perception
mime	act
electrocution	execution
preserve	sphere
attainment	accomplishment
descent	motion
insert	put
ease	change
chaos	confusion
privilege	advantage
camp	change
psychiatry	medicine
outflow	flow
cause	make
richness	value
suicide	kill
stonewall	obstruct
organizer	thinker
hate	emotion
set	descent
flower	angiosperm
promulgate	announce
mole	sauce
cricket	play
matter	trouble
present	give
fantasy	imagine
bench	subgroup
swell	wave
define	specify
predicate	phrase
asparagus	herb
torture	injure
cleavage	state
ethic	principle
blackmail	influence
singularity	unfamiliarity
director	supervisor
fund	finance
lower	movement
placard	post
pay	give
fake	imitation
amalgam	alloy
refresh	change
gulp	talk
desperado	criminal
obstetrician	specialist
identity	operator
roan	horse
credit	trust
schizophrenic	psychotic
mongolian	altaic
draftsman	artist
hunt	yaw
turntable	tray
internationalist	advocate
driver	operator
rank	stand
disagreement	conflict
handler	agent
price	value
development	improvement
gossamer	gauze
necessitate	lead
chip	shape
ammunition	material
marcher	inhabitant
cord	fabric
heartbeat	force
timidity	fear
cornu	structure
dress	finish
dirk	dagger
ancestry	inheritance
lifeline	line
reap	gather
connection	union
diary	journal
rhythm	cyclicity
connect	hit
stage	platform
anticipate	act
sip	drink
pain	symptom
digestion	learn
tour	journey
distortion	damage
filly	foal
fall	perianth
ink	fill
send	cause
battleship	warship
cheat	deceive
betrayal	treason
gust	wind
nibble	bite
recruit	engage
tor	rock
vet	inspect
seal	stamp
patrol	protection
pessimism	despair
cut	shorten
sermon	lecture
flagship	ship
roe	seafood
bowl	dish
common	pasture
shade	mark
form	mold
moroccan	african
scar	deface
invite	request
seriousness	badness
declare	play
succumb	die
pledge	oblige
massacre	kill
vulnerability	danger
kiowa	tanoan
powder	medicine
differential	difference
analogue	similarity
abandon	unrestraint
harshness	roughness
swing	move
model	representation
focus	distinctness
loch	inlet
unionize	enroll
crank	rotate
divide	calculate
break	collapse
express	realize
drive	throw
foam	bubble
header	beam
driver	golfer
pawn	chessman
identity	sameness
receptionist	secretary
particulate	material
barrier	mechanism
authenticate	attest
fatalism	credence
reconsideration	consideration
venturi	tube
condominium	dwell
shoe	case
comedienne	comedian
derivation	begin
report	news
slot	slit
quadruple	multiple
rub	contact
aster	structure
roommate	friend
wop	italian
turnout	rotation
cavalier	monarchist
contamination	impurity
incumbency	position
saboteur	destroyer
pay	be
suffer	tend
beak	mouth
thalidomide	sedative-hypnotic
investigate	analyze
honeycomb	change
improvise	perform
plaque	spot
resign	accept
shell	cover
revival	rally
peasantry	class
write	communicate
nose	front
ditto	repeat
calypso	orchid
profile	identification
wane	decrease
file	formation
stone	attacker
bloodbath	slaughter
pick	remove
authorship	initiation
abstinence	self-discipline
accessory	clothe
numerology	discipline
banter	repartee
fade	disappear
carnivore	placental
caper	robbery
vegetation	collection
ventriloquist	performer
restoration	repair
acrylic	paint
slalom	ski
pendulum	apparatus
preservation	protection
collect	get
tea	herb
temper	feel
anticipate	expect
sectarian	bigot
puncher	boxer
sophistication	falsification
purchase	acquisition
compatibility	sympathy
resentment	hostility
wind	weather
volition	choice
service	function
man	person
model	expose
repute	honor
fundamentalist	protestant
session	meet
adapter	device
mushroom	agaric
run	succeed
awkwardness	unskillfulness
slate	criticism
run	be
cumin	herb
head	striker
realist	philosopher
over	part
botch	fail
duplication	copy
effluent	waste
umbrella	canopy
appear	happen
chiron	centaur
thalia	grace
delinquency	negligence
mesa	tableland
ribbon	strip
superiority	advantage
set	bury
more	convention
kat	stimulant
condition	learn
afro	hairdo
rescue	take
layoff	closure
bite	grip
explanation	statement
testosterone	androgen
patch	program
load	fill
counterfeit	imitation
skim	larceny
explain	inform
street	thoroughfare
checker	man
tangle	perplexity
beg	hedge
shipwreck	ship
champ	chew
calendar	list
shatter	break
mileage	ratio
swastika	tetraskelion
cove	cave
mantra	motto
gardenia	shrub
company	organization
discontent	dissatisfy
period	part
bai	tibeto-burman
substitute	equivalent
capture	get
idiot	simpleton
cascade	arrange
daphne	nymph
presage	forebode
toilet	dress
expectation	feel
denote	designate
wallow	exult
amphitheater	stadium
superlative	adjective
muffler	scarf
specify	be
dream	perfection
step	run
skagit	salish
model	hypothesis
fist	hand
indicate	inform
author	write
fall	disappear
quinine	antimalarial
hurl	express
expansion	function
approval	message
sum	whole
stake	gamble
auctioneer	agent
weight	coefficient
bait	harassment
puddle	spatter
circumstance	information
whirl	move
parenthood	adulthood
clap	put
guideline	line
stay	brace
block	hold
premiership	position
rule	decide
scottish	english
misappropriation	borrow
elephant	pachyderm
trouble	affect
lumber	trade
pantry	storeroom
cash	exchange
predictor	computer
neutralize	kill
swear	vow
begin	act
sharpen	intensify
wag	jiggle
courtesy	remark
rodent	placental
harmonize	match
bathtub	vessel
go	accomplishment
flannel	trouser
manuscript	autograph
antibiotic	antibacterial
duplicate	reproduce
suit	garment
quack	utter
job	duty
reconcile	agree
western	inhabitant
simplify	change
fairness	impartiality
pouch	bag
singaporean	asian
germ	structure
rhyme	match
lob	propulsion
omega	letter
shave	reduce
flyover	flight
street	opportunity
neutralize	change
handbell	chime
optic	property
letter	culture
lip	articulator
wring	twist
give	estimate
scan	examine
major	discipline
duality	property
poke	pokeweed
melodrama	comedy
real	coin
teddy	plaything
house	management
music	sound
impression	imprint
equal	compete
cable	fasten
caller	investor
scorch	burn
input	insert
capability	ability
cement	concrete
bulb	part
drain	empty
examination	investigation
rehearsal	exercise
want	demand
masthead	top
spectrograph	spectroscope
showman	booker
trek	trip
bovine	bovid
caller	announcer
abbe	abbot
immunology	medicine
tick	sew
coil	contraceptive
stay	act
dare	act
benevolence	love
lyric	text
prevail	continue
object	content
signage	collection
buckle	fastener
ardor	eagerness
amendment	correction
bandwagon	vogue
expression	communication
draw	be
close	end
wish	request
portability	movability
right	change
ballgame	situation
surcharge	overcrowd
service	couple
mason	craftsman
shoulder	transport
bread	cover
oppression	depression
measurement	activity
intonation	sing
failure	disorder
costume	supply
swap	travel
sarcophagus	coffin
passage	section
entice	provoke
breakfast	eat
wagner	music
compact	be
web	fabric
stick	be
withdrawal	removal
survival	animation
bulletproof	proof
decide	induce
covenant	agreement
pluck	pull
nationalist	advocate
snafu	snarl
fly	move
confess	admit
albacore	tuna
vietnamese	asian
gang	tool
binder	ligament
gate	operate
puff	pastry
amyloid	protein
card	see
fight	conflict
poison	destructiveness
bet	gamble
harmony	agreement
punter	boatman
diminutive	word
heart	courage
esquire	man
hook	catch
transcribe	convert
seat	room
mad	redden
scout	expert
forest	land
tick	acarine
drawl	accent
paleontologist	scientist
keg	barrel
sexton	caretaker
triangulation	trigonometry
lavender	purple
deregulate	exempt
synchronize	happen
collar	seize
spinner	maker
chop	strike
believe	expect
syndrome	complex
registrar	official
snatch	fragment
payable	liability
lounge	sit
complete	play
be	stay
infantryman	soldier
generation	phase
carry	win
tub	containerful
resent	dislike
alarm	warn
spend	payment
cheese	spool
menu	agenda
kiln	furnace
middle	point
vigil	rite
spike	projection
pack	corrective
lycopene	carotenoid
balance	remainder
nature	quality
bobsled	sled
malaise	discomfort
trench	excavate
sorcery	magic
mustard	crucifer
douse	wet
centerpiece	feature
screw	fastener
publisher	professional
name	label
relax	affect
outburst	disturbance
seal	fastener
salt	taste
plywood	laminate
stock	flower
tiger	person
consistency	property
shiite	muslim
miniaturization	shrink
carry	range
persimmon	berry
prejudge	evaluate
beehive	receptacle
identify	recognize
debt	liability
smasher	woman
fear	regret
hamstring	torment
humiliation	degradation
recognize	prize
speedboat	motorboat
contradiction	negation
fashion	make
substitute	change
aquarium	tank
pusher	dealer
impede	prevent
enact	act
irritant	annoyance
inhale	smoke
waterproof	seal
break	change
part	concern
friction	effort
remarriage	marriage
synthesize	change
patchwork	quilt
inflate	reduce
prelude	serve
aborigine	australian
reasonableness	plausibility
lockout	resistance
kite	check
infestation	fullness
fire	attack
openness	space
spark	emit
drive	travel
nut	block
slough	swamp
top	complete
salve	redress
constancy	fidelity
surge	increase
coolant	fluid
trench	put
matter	consequence
world	part
extremity	adversity
trust	property
zinc	coat
mole	blemish
contradict	disagree
interview	converse
redeem	pay
troll	angle
family	lineage
allowance	share
gobble	eat
beauty	exemplar
survey	examine
seek	attempt
builder	creator
methyl	alkyl
factor	calculate
parchment	paper
cut	meat
patron	benefactor
elan	liveliness
bed	surface
cut	reap
root	condition
crash	collide
appreciate	understand
excavate	hollow
woman	female
satisfaction	change
thirteenth	rank
undress	nakedness
quarantine	isolation
coerce	compel
play	sound
performance	action
furniture	furnish
stretch	pull
look	be
spark	fragment
vancomycin	antibiotic
say	speech
scandal	trouble
ease	affluence
farm	cultivation
shrug	gesticulate
lubrication	condition
consonant	phone
faggot	embroider
gel	colloid
floor	land
thrash	beat
timetable	schedule
prove	print
wife	spouse
fluff	blunder
shah	sovereign
sexism	discrimination
title	appellation
diaspora	distribution
choir	area
steadiness	resoluteness
wind	rotation
brotherhood	friendliness
betterment	improvement
resignation	despair
booker	agent
dine	eat
exemplar	ideal
style	make
mend	garment
segue	continue
hue	change
prosecution	collection
temper	weaken
action	plot
notch	indentation
puppeteer	performer
duck	move
misuse	use
keep	confine
chagrin	embarrassment
nausea	symptom
constitutionalist	advocate
shanghai	kidnap
equatorial	telescope
bear	take
war	contend
drive	move
rope	line
senor	title
creature	slave
balloon	expand
slit	crack
munition	armament
fly	space
rail	railway
course	traverse
ooh	exclaim
candle	examine
hazard	obstacle
topaz	mineral
babysitting	care
quarterfinal	match
negation	statement
gear	mechanism
falcon	hunt
dun	darken
necktie	neckwear
antigen	substance
antique	antiquity
bootstrap	help
serial	broadcast
elephant	herb
lift	aid
dollar	symbol
cologne	perfume
inheritance	acquisition
inga	tree
contend	claim
pang	pain
cartoon	draw
roller	wheel
placement	position
shard	piece
announce	inform
foe	rival
dean	elder
drive	crowd
information	message
poll	position
stamp	impress
sharpen	change
grain	foodstuff
spokesperson	advocate
refrigeration	preservation
hip	fruit
detach	separate
record	number
kit	case
recede	change
emanate	come
tend	attend
withdraw	travel
lease	contract
understand	know
revolutionize	indoctrinate
produce	food
bleed	empty
palatine	roman
ascendant	dominance
buffet	strike
dibs	claim
order	request
anticipation	hopefulness
spur	equip
gossip	conversation
sack	take
manufacture	make
ray	pedicel
enchantment	sorcery
coastline	outline
eccentric	anomaly
cubby	room
troop	march
cord	line
marmalade	conserve
sliver	shape
rake	move
headline	supply
honor	stand
buddha	saint
mantle	epidermis
root	form
alpaca	llama
shoot	weave
pave	mount
dolly	conveyance
cherry	wood
pier	support
perceive	understand
peg	stabilize
base	flank
lens	channel
command	handiness
gout	arthritis
cloudiness	opacity
reintroduce	introduce
backfire	miscalculation
round	path
warehouse	storehouse
brother	monk
league	unite
bookmaker	maker
prelude	play
coordination	skillfulness
scatter	distribution
sequence	film
awe	wonder
levy	charge
wrong	injury
successor	offspring
analysis	investigation
hacker	programmer
contact	touch
crayon	draw
reproduction	recall
surfboard	board
involve	include
oneness	identity
wash	work
mound	structure
pinball	game
spare	give
gusto	enjoyment
integrate	compound
permit	pompano
shuttle	travel
grandstand	audience
wise	manner
bid	plead
referral	case
hijack	assume
overdraft	draft
temptation	influence
dog	chap
occidental	inhabitant
decomposition	decay
cane	switch
guard	defender
scheme	plot
nail	attach
speculator	thinker
murder	homicide
tap	sound
type	block
diagram	draw
poach	cook
warden	lawman
stun	immobilize
comedy	drama
tonga	bantu
freestyle	race
interchange	junction
hydrologist	geologist
dick	detective
shoot	emit
compression	encode
floater	swimmer
why	reason
camp	shelter
encroach	advance
collar	band
fryer	chicken
cottonwood	poplar
return	travel
voucher	document
loft	hit
guard	protect
substrate	surface
yachtsman	sailor
sable	scarf
appetizer	course
crash	happen
disorganization	disorderliness
blog	communicate
indicator	device
endocrinology	medicine
trail	pursuit
supplement	increase
measure	decide
upgrade	grade
jostle	push
life	be
agreement	statement
knesset	parliament
derringer	pistol
sign	communicate
suit	meet
fence	receive
bother	intrude
reclamation	rescue
docket	put
scale	climb
monologue	speech
footman	manservant
sound	measurement
cruelty	heartlessness
impartiality	inclination
show	appear
synthesis	reason
convert	persuade
walk	score
renunciation	rejection
repose	lie
consent	permission
americanism	patriotism
isolation	separation
spree	gratify
autopsy	examine
starling	oscine
fly	operate
flutist	musician
withdrawal	termination
carter	worker
magnetism	geophysics
spell	hex
withhold	subtraction
apron	site
harp	chordophone
interval	set
admit	permit
wrap	sandwich
broadside	hit
gourd	bottle
silt	soil
prove	be
craft	skill
airmail	mail
misrepresentation	falsehood
usher	escort
repatriation	return
privacy	reclusiveness
tax	charge
pander	provide
proof	argument
completion	maneuver
simulator	machine
wander	proceed
light	illumination
glutamate	salt
respondent	codefendant
mammal	vertebrate
cat	woman
salvo	cheer
convertible	sofa
aviary	build
recuperate	good
odds	ratio
simmer	temperature
work	use
demand	claim
procurement	acquisition
lend	be
racism	discrimination
espionage	spy
prerogative	right
give	distribute
hanover	royalty
schedule	plan
racehorse	horse
toehold	status
break	destroy
credit	attainment
hank	coil
margarita	cocktail
bite	fragment
pocket	open
circulate	move
epidemiology	medicine
derivative	word
transgress	spread
packet	message
akwa	hokan
swell	grow
suffocate	stifle
fee	interest
raise	collect
perfectionist	compulsive
breathe	express
redhead	person
suffix	affix
medusa	coelenterate
nova	star
metal	coat
attitude	affectation
squeeze	constriction
iraqi	asian
picture	illustration
give	stretch
speed	pace
hack	writer
reservation	statement
spam	e-mail
dive	descent
animation	animateness
glance	look
dust	smear
conflict	incompatibility
tag	touch
envelope	container
service	work
murmur	complain
carve	cut
rabbit	leporid
bankrupt	impoverish
vertebra	bone
pay	requite
deduction	inference
revoke	mistake
playfulness	frivolity
deficit	liability
reinterpret	rede
siberian	russian
abrasion	erosion
centrifuge	apparatus
cavern	enclosure
smallness	weakness
crab	shellfish
bigot	partisan
baton	staff
count	lord
inventory	list
depth	extent
smear	defamation
agent	businessperson
wrest	seize
protest	resistance
break	solve
firebomb	bombard
board	populate
modernization	improvement
humiliation	shame
dive	swim
give	show
custom	duty
explosive	chemical
reasonableness	inexpensiveness
predispose	dispose
stable	accommodation
reset	specify
accommodate	provide
ferry	travel
share	distribution
sift	travel
odyssey	journey
apology	example
chap	legging
bigamy	marriage
enzyme	protein
discover	learn
squelch	suppress
head	be
groove	depression
circulate	run
pacifism	doctrine
climber	athlete
deception	falsification
weave	handicraft
immobilize	restrict
underlie	lie
infiltrate	join
flaunt	display
erase	kill
hymnal	songbook
graphite	carbon
mediate	lie
switch	hairpiece
tee	put
submerge	immerse
fast	abstain
placebo	medicine
echo	analogue
term	word
arrival	traveler
induce	generate
unsold	detach
ostrich	person
shut	motion
epitome	outline
arum	starch
case	containerful
bandy	play
tag	attach
broadside	armament
wireless	telecommunication
sprint	run
eleventh	rank
marble	ball
type	symbol
orthodontist	dentist
mother	inspiration
butch	kill
wean	substitution
conviction	belief
executive	administration
distress	disturb
glove	handwear
liability	susceptibility
blow	stroke
damage	compensation
twig	branch
serenade	song
gun	weapon
caisson	chamber
heiress	heir
delight	pleasure
rekindle	arouse
abatement	moderation
file	smooth
discriminate	spot
harness	support
stewardess	steward
girdle	surround
develop	expand
burlap	sack
distraction	confusion
discharge	material
virginity	condition
hypnotist	psychologist
hemoglobin	hemoprotein
substrate	substance
sit	be
cut	transit
retirement	withdrawal
unilateralism	doctrine
elaborate	produce
hen	bird
vest	give
exhibit	evidence
feature	property
connoisseur	authority
flex	flaunt
detail	elaborate
bob	weight
concentration	strengthen
tire	hoop
pay	settle
six	digit
submission	condition
house	build
literature	profession
line	mark
attendant	assistant
gyro	sandwich
twenty	decade
stack	load
maid	girl
confirm	approve
fend	cope
opiate	narcotic
teton	sioux
corrosion	deterioration
whoopee	revel
exposure	disclosure
korean	altaic
mohawk	iroquoian
sympathy	affinity
illustration	representation
flourish	grandiosity
madame	dame
headgear	hoist
trash	discard
run	last
extension	delay
romanov	dynasty
latitude	scope
tip	reorient
braid	trim
float	test
cloud	vaporization
cart	transport
leadership	body
zeitgeist	spirit
coo	utter
emulate	compete
additive	addition
minstrel	performer
reservoir	tank
carbonate	salt
inventory	register
cranberry	shrub
bodyguard	defender
berber	african
institution	establishment
message	communicate
idea	content
file	fragment
methylphenidate	stimulant
choice	action
oilfield	field
mold	container
penance	punishment
medication	therapy
fan	intensify
color	decorate
ox	cattle
envelope	wrap
pass	license
excavate	obtain
minimum	extremum
rosemary	herb
mullah	muslim
stand	rest
altitude	elevation
beer	brew
topple	push
finger	placement
rice	cereal
privilege	right
awareness	consciousness
form	document
blow	exhalation
kill	fatality
wall	partition
placebo	vesper
clamor	demand
flotsam	wreckage
dame	woman
theology	discipline
equivocation	falsification
movie	product
gun	blast
support	resource
prepayment	payment
fester	sore
repudiation	exposure
escape	mean
repent	feel
philosopher	scholar
budget	calculate
low	degree
caretaker	official
protest	objection
abomination	transgression
failure	unfortunate
glut	overabundance
weakness	property
neutrality	non-engagement
belly	underpart
break	happen
planter	pot
columnist	journalist
afflict	upset
delivery	transportation
soak	beat
tangerine	mandarin
blowout	malfunction
severity	sternness
medium	communication
occult	practice
revision	rewrite
raise	gamble
preposition	place
furrow	cut
fog	aerosol
unanimity	agreement
command	demand
forgetfulness	amnesia
reflux	pathology
tension	balance
atrocity	inhumaneness
dysfunction	pathology
ninth	rank
arthritic	patient
fold	change
redemption	repayment
cardinal	red
perseverance	continuance
whiteness	complexion
foam	material
store	accumulation
civilian	citizen
stock	handle
division	phylum
aggression	action
angle	space
leadership	activity
control	spirit
motorcycle	cycle
praise	approval
balance	equilibrium
orderly	attendant
bleach	discolor
elbow	jostle
universal	rule
trap	mouth
broiler	chicken
pill	burden
verse	write
title	subheading
company	unit
foot	pay
slow	decelerate
spoil	plunder
marina	dock
slice	part
bone	remove
plane	smooth
hack	tool
dane	european
sheik	ruler
back	switch
gardener	employee
alum	astringent
precedent	subject
concentrate	prototype
identity	personality
flea	insect
lead	leadership
sylvan	spirit
support	act
track	observe
skirt	bind
launch	motorboat
hopelessness	despair
embarrassment	shame
gelatin	scleroprotein
floater	policy
schism	rupture
egghead	intellectual
distribute	spread
corona	cigar
control	activity
suffix	end
socialist	politician
rule	duration
isolate	discriminate
cemetery	site
countryman	rustic
strike	penetrate
quilt	sew
bank	fund
containment	system
clearance	license
wavelength	distance
enroll	register
personification	person
amputate	remove
traditionalist	conservative
puritanism	protestantism
ginger	spice
print	fabric
hotdog	exhibitionist
construct	make
pork	meat
groin	edge
slaughter	kill
con	argument
oilman	businessman
cloudiness	semidarkness
molester	wrongdoer
canal	channel
destabilization	change
fullness	property
wig	chide
grill	cook
runoff	election
gulf	disparity
quadrant	line
bourbon	reactionary
devil	trouble
arouse	move
bed	supply
chock	hold
ukrainian	slavic
bridesmaid	woman
weigh	measure
articulate	state
ecology	environment
magnificence	elegance
proclamation	act
drag	move
mail	message
catch	delay
night	dark
rubbish	waste
project	draw
confluence	blend
louden	change
incapacity	incapability
stoop	pounce
conformity	orthodoxy
involve	admit
luck	phenomenon
move	sell
jackal	canine
hire	employee
introvert	person
pottery	trade
jar	containerful
clarify	explain
coil	reactor
iodine	halogen
fight	contend
infielder	fielder
stalemate	draw
say	convey
fob	adornment
cast	delegate
gamble	risk
catechism	book
act	be
dropout	quitter
tolerate	suffer
evasion	misrepresentation
macon	wine
lighten	cheer
cut	be
sumac	shrub
splurge	ostentation
landfall	seashore
cup	bloodletting
fly	hit
mother	parent
ceiling	altitude
bystander	spectator
shave	groom
good	surpass
togetherness	closeness
update	change
hammer	blow
peach	drupe
lift	move
stipulation	concession
oyster	help
challenge	object
throne	govern
tap	plate
stairwell	well
forecaster	visionary
pit	enclosure
cuddle	embrace
series	polynomial
affection	feel
appeal	challenge
stride	walk
meet	have
foul	dirty
laver	basin
bedrock	rock
roll	robbery
thrust	criticism
poi	dish
family	kin
boil	vaporization
spray	cover
waste	enfeeble
digest	grok
reed	vibrator
denim	fabric
puritanism	sternness
syntax	grammar
subsidy	grant
electrification	exploitation
steadiness	regularity
cab	carriage
chauvinist	bigot
blur	change
adulthood	maturity
flaw	fail
crack	sound
record	accomplishment
match	score
muller	vessel
come	experience
boil	change
subcontract	contract
please	wish
creation	activity
surcharge	fill
parameter	constant
haw	utter
sling	bandage
dim	darken
disqualification	prevention
smash	collide
hat	wear
dungeon	cell
switch	control
squid	seafood
precipitate	hurl
mojo	magic
sass	rejoinder
mumble	enunciation
force	organization
drain	depletion
cove	inlet
junction	connection
notice	tell
interest	share
behalf	stead
theory	explanation
butt	put
censor	person
forget	neglect
fragment	piece
document	representation
raja	aristocrat
patrimony	endowment
solicit	request
tack	bear
lock	hold
psychoanalysis	psychotherapy
canter	gait
antiseptic	medicine
content	list
deck	packet
blaze	mark
hysterectomy	ablation
shuffle	manipulate
speculator	gambler
importance	value
nude	statue
skip	gait
harass	annoy
dislocation	disruption
image	visualize
ultimate	quality
flight	formation
initiate	scholar
friendliness	disposition
fondue	dish
hacienda	estate
omani	arab
probe	investigate
tar	coat
generality	quality
visit	tour
zero	adjust
embargo	stop
hope	feel
bake	cook
illiteracy	inability
stain	soil
rhesus	macaque
disobey	refuse
tempt	arouse
sting	pierce
bleed	injury
sling	hang
venue	jurisdiction
rote	memorization
dowry	gift
reparation	compensation
ignite	burn
steep	vessel
walkout	protest
mint	herb
alto	pitch
shindig	party
strike	delete
prognosis	prediction
percussion	detonation
fumble	play
hedge	fence
eagle	shoot
levant	morocco
concentration	space
thank	aid
anoint	bless
regularity	symmetry
port	change
plunder	take
tail	rear
asparagus	vegetable
injection	insertion
meet	convergence
advertiser	publicist
study	think
maestro	artist
falter	move
floater	voter
drop	descent
cage	constraint
fume	emit
yiddish	german
visitation	visit
chairmanship	position
logic	principle
contradict	deviate
obsolescence	degeneration
accommodation	aid
irrelevance	unconnectedness
zeta	letter
align	match
cut	part
archive	collection
galley	kitchen
suite	set
chowder	soup
cleave	indentation
plead	declare
watch	surveillance
parsley	herb
choir	set
mocha	flavorer
winnebago	sioux
dioxide	oxide
shear	deformation
strain	deformation
darken	tarnish
slop	fee
egress	act
rise	motion
turkmen	turki
bridle	restrain
regenerate	re-create
divinity	fudge
stigma	blemish
ramadan	fast
rust	oxidise
chuck	caress
wander	travel
poll	parrot
hail	greet
dermatology	medicine
ratification	agreement
pipe	transport
mauritanian	african
satchel	baggage
colliery	workplace
gold	wealth
consume	spend
parley	negociate
translator	program
monochrome	paint
vane	fin
rebuff	reject
run	process
basic	commodity
tolerate	respect
progress	motion
animation	be
taste	perceive
opera	theater
drudgery	labor
cage	confine
comeback	reappearance
covey	flock
merit	worth
activation	begin
build	make
magnification	ratio
demonstrate	protest
ladder	stair
home	environment
figure	model
ebony	tree
incidence	frequency
dig	thrust
net	goal
drain	run
bartender	employee
scoop	ladle
domination	dominance
cinnamon	bark
accompaniment	part
adjust	change
canteen	restaurant
haul	transportation
silly	child
awol	absentee
hem	sew
plunge	drop
pasture	grassland
fork	cutlery
chic	elegance
bugler	trumpeter
pacer	racehorse
bidder	applicant
cremation	incineration
boom	sound
install	put
galician	romance
downsize	furlough
disgust	dislike
uplift	rise
impair	damage
jolt	disturb
impact	wedge
jest	diversion
venue	scene
generalization	transfer
floater	employee
miracle	happen
summit	meet
visionary	person
bane	affliction
jaw	feature
reckon	estimate
test	cover
finger	digit
scarecrow	effigy
isolation	alienation
fiddle	play
representation	state
layout	order
terrace	row
invalidate	change
honeycomb	penetrate
futility	inutility
card	record
polygamy	marriage
librarian	professional
safety	score
heresy	content
tapper	eavesdropper
ewe	kwa
interface	program
starch	stiffen
curvature	condition
tonight	present
choke	fail
seven	digit
traffic	communication
coverage	sum
scalp	skin
disregard	inattention
shoot	grow
enlarge	grow
repatriate	admit
external	feature
projection	prediction
grain	seed
shop	obtain
hive	store
cabaret	show
package	container
misdemeanor	crime
english	nation
gamble	diversion
eye	opinion
summer	spend
crystal	rock
reveal	unwrap
inaugurate	start
timeline	chronology
wax	increase
catch	touch
crust	layer
humpback	cripple
smoke	consume
fallacy	misconception
stall	seat
wave	rise
begin	point
magnetometer	meter
electrode	conductor
watch	shift
qing	dynasty
resolution	harmony
cedar	wood
bishop	chessman
parish	jurisdiction
penne	pasta
ruin	destruction
benefit	payment
bey	governor
legislature	assembly
puddle	pack
harden	symptom
blow	sound
form	make
abyss	chasm
massage	manipulate
clamor	cry
taboo	restrict
character	repute
confederate	southerner
terrace	supply
telescope	squash
racetrack	course
graze	injure
springboard	board
stall	obstruction
coolness	calmness
crack	change
anesthetic	drug
violet	purple
turf	jurisdiction
lot	tract
oatmeal	porridge
acquire	act
touch	change
substance	matter
deliberation	discussion
connivance	approval
pocket	space
see	detect
codex	manuscript
signify	indicate
irregularity	quality
slowdown	delay
almond	drupe
scavenge	fee
cavern	cave
score	debt
lyric	write
landscape	garden
follower	person
stretch	straightaway
map	picture
expansion	discussion
anticipate	know
proliferate	multiply
commission	authorize
bagger	machine
thalidomide	teratogen
limit	boundary
hold	postpone
prodigy	exemplar
detriment	damage
accessory	component
come	happen
prism	polyhedron
ball	dance
corps	body
foreclosure	proceed
gather	collection
fence	play
pathan	afghan
stage	discard
check	verify
hem	edge
spider	program
mess	nutriment
boo	cry
bull	push
abuser	wrongdoer
nondescript	person
entrust	pass
stipe	stalk
keynote	address
exhaust	tire
courtship	entreaty
yea	affirmative
sole	flatfish
numb	desensitize
lamb	innocent
will	ordain
pavilion	tent
dump	copy
frolic	play
flux	pathology
cling	touch
embellishment	expansion
balancer	acrobat
bang	exhilaration
inject	drug
return	reciprocate
dispatch	transport
fluoride	halide
cynic	philosopher
sluggishness	pace
grab	seize
incorporate	make
levi	jean
rat	pad
transition	passage
pace	step
purpose	goal
serve	provide
seismologist	geophysicist
love	emotion
still	apparatus
tune	alteration
conflict	transgress
material	equipment
economy	frugality
boat	vessel
skim	read
commission	authorization
stagecoach	coach
bounty	reward
tramp	vagrant
harp	play
auction	bridge
esteem	honor
reshuffle	shuffle
shock	fight
gown	dress
stub	weed
sandwich	organize
casket	enclose
panache	plume
mustang	pony
alcohol	beverage
drag	proceed
slasher	attacker
shriek	shout
voice	communication
recommendation	praise
support	activity
slam	victory
libel	complaint
buzz	activity
header	hit
straightaway	section
expedition	campaign
campaigner	politician
subscriber	customer
tape	record
introduce	inform
forfeit	penalty
obstetrics	medicine
benefit	help
portfolio	list
suggest	express
redevelop	develop
phase	appearance
scan	examination
comparative	adjective
bob	inclination
stir	agitation
spin	stream
mitzvah	teach
fare	eat
notebook	book
centurion	warrior
head	form
mismatch	match
baby	fetus
announce	state
chiropractic	treatment
drive	hunt
radiocarbon	carbon
mambo	dance
screen	choose
placement	contact
snap	break
slack	trouser
birth	change
scholar	intellectual
methamphetamine	amphetamine
prevail	persuade
therapeutic	medicine
avalanche	slide
immediacy	directness
inevitable	destiny
equity	asset
dissatisfaction	discontentment
mechanism	device
sulfate	salt
wear	have
disposition	nature
notice	react
shake	agitation
coalition	union
splash	dirty
interdict	destroy
deal	treatment
pirate	plunderer
apply	give
marshal	lawman
protestant	christian
huck	towel
runner	jack
file	submission
pound	restrain
pull	row
prize	see
surface	boundary
melt	blend
wilt	weaken
king	checker
catawba	siouan
buy	get
cannonball	projectile
fact	information
dagger	knife
detour	road
recess	put
chat	conversation
wedge	move
dropout	individualist
shareholding	property
poach	hunt
requirement	duty
allegation	claim
splash	overlie
businessmen	profession
acceptance	situation
duster	pitch
horizon	scope
machismo	masculinity
anarchist	radical
linger	persist
conformity	cooperation
spandex	fabric
offense	operation
vent	orifice
iroquois	indian
satisfaction	payment
soloist	musician
consolidate	solidify
swell	enlargement
arrears	debt
tolerance	allowance
nudge	push
format	information
witchcraft	sorcery
conservancy	conservation
cast	shape
isolate	get
plump	choose
silica	oxide
stock	stalk
responsibility	trustworthiness
lightweight	wrestler
gargoyle	spout
yeoman	bodyguard
notice	review
mayan	indian
hell	mischief
ramble	amble
accreditation	certification
administer	treat
ghetto	life
vest	garment
baa	foreman
overture	suggestion
study	learn
wicket	gate
mistrial	trial
motorcade	procession
thump	blow
characteristic	property
stamp	class
grind	degree
ramrod	overseer
stew	dish
transfer	ticket
wed	ceremony
edge	limit
preponderance	number
emblem	symbol
biennial	plant
defect	flee
dodder	vine
gear	adapt
form	manner
flounder	fight
amputation	disability
porridge	dish
spanish	romance
blue	organization
gain	get
silhouette	project
brad	nail
contract	sicken
baldness	hairlessness
property	possession
conditioner	coach
crisis	situation
angle	travel
cadaver	body
feel	awareness
repairman	mender
direction	position
ringer	double
respite	pause
shower	spray
primitive	formula
arapaho	algonquian
jersey	shirt
litigation	proceed
autobiography	biography
wrench	pull
par	score
unseat	remove
tarzan	man
sector	aspect
finalist	rival
slam	impact
shoot	projectile
subject	submit
prefecture	position
berry	pick
etch	engrave
recitation	matter
parody	act
buddy	friend
individual	organism
put	change
wisdom	content
lesson	teach
deflate	change
kite	plaything
snorkel	dive
happiness	feel
eightieth	rank
self	consciousness
seduce	entice
linguist	scientist
fade	weaken
jerky	meat
exit	open
watermelon	melon
hibiscus	mallow
fennel	vegetable
population	colonization
raincoat	coat
hinduism	religion
reference	publication
clear	improvement
bang	travel
reduce	impoverish
incrimination	accusation
flare	fly
wherewithal	mean
consort	spouse
harrier	hound
vector	virus
blood	daub
latch	catch
shear	change
sandbag	bag
matrix	array
glimpse	view
octave	stanza
easel	tripod
interest	curiosity
lacquer	gum
coppersmith	craftsman
boredom	dissatisfaction
chlorophyll	pigment
upgrade	software
flood	fill
cure	preserve
test	evaluate
plumber	craftsman
cheese	discontinue
lair	habitation
fall	fail
grumble	utter
segment	part
approve	authorize
overlook	survey
bevy	gather
coney	grouper
enthusiasm	interest
republish	revive
sage	herb
call	indicate
line	score
baggage	case
problem	difficulty
workshop	course
baroness	lady
romper	person
backlog	accumulate
indiscretion	folly
rice	starch
hose	tube
colbert	sauce
pia	herb
election	predestination
vaccine	immunogen
teach	education
valve	shell
opine	declare
roundup	summary
pound	partition
error	happen
raven	fee
purge	purify
fertilize	enrich
shade	inferiority
occupy	populate
worry	anxiety
last	rank
rim	line
imitation	copy
deal	transact
clarinetist	musician
fudge	cheat
see	consider
hoist	raise
aggregate	material
trip	hallucination
trout	fish
fly	travel
interconnect	connect
cut	make
fail	worsen
belt	fasten
tail	process
stretch	grow
duel	struggle
float	swim
induction	introduction
property	concept
port	drink
balance	scale
squadron	cavalry
thickness	dimension
specific	medicine
royal	stag
special	dish
opportunism	selfishness
handicap	disadvantage
fashion	vogue
damsel	maid
freon	chlorofluorocarbon
eccentricity	unfamiliarity
communication	discipline
get	destroy
keel	projection
port	turn
edit	censor
commitment	engagement
derivation	draw
lake	pigment
mouthpiece	spokesperson
routine	software
force	act
pantheon	temple
folklore	lore
abstraction	removal
solid	matter
blend	mix
migration	person
taker	customer
character	recommendation
gymnast	athlete
mate	animal
initial	sign
prankster	troublemaker
engineer	room
nucleus	center
bill	advertise
account	explanation
family	association
preoccupation	idea
crank	flex
bogey	score
symmetry	balance
quarry	exploit
hostility	combat
surface	layer
gas	fluid
conservatory	school
can	preserve
standard	value
rheumatology	medicine
fob	chain
conclusion	assumption
break	separate
fluidity	thinness
polynesian	austronesian
downdraft	draft
felon	infection
hood	neighborhood
production	industry
air	medium
butane	fuel
manor	mansion
admirer	lover
atmosphere	weather
collection	group
taste	modality
kerosene	hydrocarbon
preservation	condition
bag	sag
astrodome	dome
tendency	disposition
bough	limb
methotrexate	antimetabolite
bow	knot
snare	trap
heal	good
override	counteract
solo	fly
ottoman	dynasty
card	paper
dot	cover
redden	discolor
wonderland	land
look	convey
ski	travel
finish	downfall
welcome	receive
legislator	politician
illegality	unlawfulness
janitor	custodian
juxtaposition	position
extension	education
howl	cry
fair	exhibition
bludgeon	club
nun	letter
ride	continue
catch	hear
delivery	conveyance
withdraw	remove
remain	be
admonition	advice
canton	divide
case	problem
deny	contradict
alder	wood
hunk	man
form	appearance
emblem	design
pop	hit
follower	traveler
skin	animation
midwifery	delivery
misbehavior	wrongdoing
accord	agreement
mash	suspension
approximation	similarity
dash	thwart
nap	sleep
trench	ditch
totem	kin
static	mechanic
mafia	syndicate
character	adult
drop	discontinue
macro	instruction
stoicism	unemotionality
assume	expect
feint	maneuver
hanger	support
earl	peer
rewrite	edit
devil	exclamation
buster	horseman
dismember	separate
individualism	doctrine
puzzle	game
association	group
condensation	process
felicity	appropriateness
nude	person
attack	act
breed	copulate
furrow	dig
tor	hill
berth	supply
agreement	harmony
graze	eat
catcher	infielder
generosity	share
gaze	stare
sink	move
regency	rule
bunker	hit
sinus	cavity
crescendo	increase
bid	play
martyrdom	death
monopoly	market
storm	attack
designation	determination
holdover	official
round	shape
immigrant	migrant
revision	transformation
reception	greet
smother	cover
remedy	treat
angora	rabbit
gravitate	move
sinecure	benefice
rendezvous	meet
adventure	undertake
plug	close
menial	servant
fiduciary	person
honk	utter
shortstop	infielder
space	rate
mistake	misconception
recall	memory
suffocate	die
knot	bunch
mercury	temperature
atmosphere	region
peacekeeper	soldier
pretense	misrepresentation
sin	activity
quicksand	situation
swing	socialize
holiness	quality
lee	side
capsize	shipwreck
mince	walk
cocoon	seclusion
methanol	alcohol
demonstration	protest
pile	money
samurai	nobility
energy	force
land	arrival
schoolmaster	snapper
storm	penetrate
hark	listen
affair	transaction
master	education
atrium	chamber
latter	second
bikini	swimsuit
sparkle	expression
don	title
decision	choice
heavy	actor
define	characterize
basis	assumption
ready	readiness
occasion	cause
figurine	figure
teamster	driver
bar	ridge
mellow	soften
admit	serve
swoop	foray
rosary	bead
rejection	act
grease	cover
middle	part
range	assortment
tritium	hydrogen
jolt	move
complex	feel
pinch	grip
pardon	warrant
horseradish	condiment
romanian	european
rubicon	line
hit	touch
dissolve	change
teach	habituate
lure	attraction
joint	cigarette
cog	tooth
institute	association
penetrate	understand
objectivity	judgment
table	array
schooner	glass
decorate	honor
drill	train
catharsis	purge
stock	supply
chatter	sound
diver	swimmer
weld	joint
swindle	fraud
floor	control
beehive	hairdo
gunnery	weaponry
surveyor	engineer
facet	subfigure
preview	screen
camper	vacationer
investment	committedness
champion	rival
occur	appear
muscat	vinifera
lurch	gait
indignity	insult
photocopy	reproduce
sweet	dainty
creep	pen
compass	capability
lathe	shaper
arctic	overshoe
ironclad	warship
relax	act
relive	experience
feast	thing
noose	fasten
triangulation	survey
slip	worsen
majority	number
turn	move
newspaper	publisher
copyright	procure
split	share
reef	strip
knock	misfortune
bar	rail
tease	manipulate
evaporate	change
redundancy	repetition
refit	equip
lynx	wildcat
invade	attack
tramp	footfall
escort	protection
excess	immoderation
sulfide	compound
ingenue	actor
buckwheat	herb
coil	structure
drumstick	help
digest	systematize
barber	groom
embrace	clasp
possession	enchantment
deficit	score
hiccup	breathe
cable	television
durham	beef
trial	affliction
test	attempt
indonesian	asian
aster	flower
parisian	frenchman
continuity	lastingness
ventricle	chamber
plumb	adjust
catch	restraint
forty	decade
pore	hole
journalism	profession
see	visit
commitment	confinement
oil	cover
eligibility	qualification
history	past
shoebox	box
toxin	poison
levee	pier
sovereign	ruler
ruffle	disarrange
acquit	pronounce
seashore	shore
recite	repeat
nutrient	substance
pair	unite
manner	demeanor
microbe	microorganism
bookseller	owner
bullfighter	person
bond	technique
commute	change
lumber	walk
count	recite
outage	breakdown
rerun	campaign
pierce	sound
agitate	move
pony	horse
union	state
watermark	marker
gazebo	build
monoculture	culture
gale	wind
commission	certificate
clout	target
downgrade	rate
fill	concoction
saber	kill
sow	put
volatile	substance
climax	juncture
menace	threat
shorthand	handwrite
discussion	speech
elect	choose
piece	part
restart	start
featherweight	boxer
sampler	assortment
band	stripe
exploration	expedition
promotion	change
scaffold	hold
orange	citrus
tempt	invite
scenario	premise
worship	attend
grass	cover
juxtaposition	placement
glass	container
silver	plate
stimulate	affect
scarf	wear
auditor	accountant
instrument	mean
dial	indicator
point	promontory
streamer	light
discard	abandonment
inclusion	involvement
punctuation	interruption
fairway	path
salt	sprinkle
flood	cover
south	direction
pass	end
rib	mold
ruby	corundom
affinity	force
refusal	message
japanese	altaic
pour	run
build	create
roost	settle
glass	containerful
twitch	pull
dock	withhold
rappel	descent
end	extremity
development	process
quail	wildfowl
mobilize	gather
stroke	oarsman
advance	wax
shell	hull
grow	develop
flex	move
circulation	spread
serbian	slav
growth	development
wing	mean
buddhism	religion
mediator	negotiator
glitter	brightness
lug	transport
attack	turn
caraway	herb
sale	sell
dally	consider
paddy	irishman
board	structure
park	room
contrarian	investor
vaseline	petrolatum
watercress	cress
court	government
hop	traverse
casket	box
petition	request
plug	insert
killer	person
bark	cover
minimize	decrease
effectiveness	power
rice	sift
chamber	assembly
transpire	happen
teflon	plastic
cyclist	pedaler
upstage	actor
consultation	conference
port	transport
design	intend
millennium	anniversary
sire	lord
ringleader	instigator
gin	separate
prosecute	act
endorsement	promotion
box	container
dismay	frighten
stand	table
newspaper	product
silkworm	caterpillar
tooth	projection
stopper	plug
hive	meet
lap	lie
catalog	list
hardwood	wood
thrust	push
orchid	flower
lead	position
trim	balance
habitation	habitat
unite	have
bathe	swim
conspiracy	plot
gossip	communicator
helplessness	depression
crop	plant
proposition	statement
inequality	difference
surprise	affect
frame	draw
feather	rotation
slovak	european
convey	impart
pick	output
work	be
warp	distortion
liquidity	exchangeability
attendance	frequency
surf	switch
gaiety	happiness
example	information
restoration	artifact
word	speech
clipper	scissor
contrast	comparison
disease	illness
man	male
pack	arrange
snowmobile	ride
breed	production
spy	investigate
scarf	masturbate
bodyguard	detachment
rush	run
mine	production
bag	baggage
semantics	linguistics
mosaic	art
parlance	formulation
beneficiary	recipient
arc	curve
seize	overwhelm
spike	rise
safeguard	protect
man	lover
butch	murderer
hill	shape
roar	cry
marry	person
autism	syndrome
bow	gesticulate
extremity	ultimacy
spill	pour
contradiction	opposition
mennonite	anabaptist
realize	make
tier	layer
vegetation	excrescence
call	request
let	leave
presence	impression
grain	paint
kota	dravidian
bombardier	aircrewman
leisure	rest
bill	see
tuition	fee
corkscrew	turn
raft	manufacture
hypnotism	influence
goldfish	cyprinid
brandy	liquor
canyon	ravine
senator	legislator
appendicitis	inflammation
disperse	separate
demolition	destruction
poacher	vessel
bluff	deceiver
masculine	gender
delay	pause
jack	raise
culture	grow
past	time
czech	european
dictation	matter
margin	boundary
fall	change
tile	cover
augur	prophet
hop	move
axle	shaft
licensee	retailer
papyrus	paper
intervene	interact
deflection	movement
dip	depression
dip	withdraw
bristle	fiber
right	faction
hostess	host
climb	rise
rash	eruption
conflict	state
tang	seaweed
coupon	sample
haiku	poem
return	transport
circuit	path
shank	cylinder
brace	strengthener
interrupt	end
write	record
tongue	projection
deflation	decrease
undertake	accept
stabilizer	airfoil
perpetuate	continue
obscurity	stand
occupancy	residency
draft	write
redeploy	deploy
slide	plaything
chlamydia	eubacteria
service	employment
engagement	employment
give	communicate
basement	floor
autoclave	vessel
gauge	thickness
offer	give
sparkle	vitality
premier	perform
taiwanese	asian
fun	wit
frailty	evil
court	cortege
sensation	excitement
dart	lunge
cheer	encourage
baffle	plate
whig	englishman
topper	coat
hustings	campaign
roll	film
rocket	vehicle
trouble	effort
spar	mineral
hardness	difficulty
keyboardist	musician
steadfastness	resoluteness
cruise	search
exorcise	eject
fret	corrode
operation	work
nut	seed
dumpster	container
vinyl	plastic
juggernaut	idol
compound	mix
weed	band
fit	tailor
pornographer	showman
pension	award
scaffold	arrangement
clone	organism
draft	dose
insulation	isolation
absolutist	disciple
yoga	hinduism
discretion	wisdom
flood	supply
spindle	stick
authorize	permit
course	nutriment
thoroughfare	road
embody	typify
mire	difficulty
nose	push
object	be
defuse	remove
tenor	mean
scent	smell
halibut	flatfish
unionization	constitution
sport	have
answer	react
mutter	sound
amendment	statement
submersible	warship
fuel	supply
time	case
bud	begin
tamper	manipulate
peacekeeper	pistol
guardianship	duty
overturn	success
corruption	inducement
theory	belief
denomination	class
hunk	part
nap	texture
cross	emblem
repression	subjugation
tent	web
outerwear	clothe
plight	assurance
walk	behave
wrestle	contend
cancel	score
ball	agglomeration
color	kind
boil	heat
outline	boundary
family	unit
declaration	statement
disinvestment	withdrawal
agenda	list
restore	refund
normality	expectedness
climax	degree
refreshment	bite
dole	share
spare	benefactor
shit	defecation
jolt	blow
eighth	rank
classic	artist
buoy	float
screwball	pitch
biplane	airplane
capitalization	write
season	toughen
think	change
inflate	change
carry	have
fare	passenger
bleach	whiten
landscape	paint
cruiser	car
shuck	remove
gamut	scope
share	overlap
nirvana	blessedness
mind	recall
citation	summon
drown	kill
gaggle	cackle
hex	charm
fluff	material
stakeholder	neutral
solicitor	lawyer
boom	happen
formula	statement
iranian	indo-iranian
accretion	increase
violence	turbulence
clarion	play
shun	avoid
birch	flog
club	stick
finn	european
cheat	victimize
overpass	bridge
inverse	opposition
suffer	worsen
complete	end
choose	darling
outcast	unfortunate
lumberyard	workplace
wholesale	sell
course	hunt
cabinet	compartment
seriousness	trait
condemn	attest
bouncer	guard
jam	stuff
peg	prosthesis
bamboo	wood
delta	letter
revolt	rebel
morality	quality
cheesecake	photograph
field	set
attachment	affection
nest	gather
ambassador	diplomat
championship	contest
aztec	nahuatl
commitment	message
quest	seek
archer	expert
prefix	affix
chili	dish
yield	accept
validate	confirm
employer	leader
pacer	horse
chit	girl
maverick	nonconformist
quantify	specify
cedar	conifer
stringer	timber
vest	dress
crumb	coat
grey	color
aviation	art
suspend	expel
intern	work
quality	degree
miss	fail
ice	freeze
diversity	condition
frequency	rate
full	workman
sleeper	terrorist
abeyance	inaction
impression	appearance
filth	unsanitariness
exposure	abandonment
oceanic	malayo-polynesian
airlift	fly
product	creation
kink	fold
observatory	build
theology	system
sprout	green
modality	treatment
fingerprint	reproduce
lizard	saurian
article	section
stay	be
branch	subfigure
overestimate	appraisal
hymn	laud
farrow	parturition
fee	food
dictator	ruler
outpace	surpass
tomato	herb
vroom	roar
rebirth	revival
mainstay	forestay
cycle	pass
flip	turn
formaldehyde	aldehyde
province	sphere
affinity	kinship
malik	leader
need	necessity
violinist	musician
cur	dog
gateway	entrance
bore	cut
clear	liberation
make	component
sainthood	position
propaganda	information
sauerkraut	dish
nod	gesticulate
advance	increase
spirit	character
fine	penalty
reverence	action
rinse	wash
paralegal	paraprofessional
speculate	invest
reconstruct	change
floss	thread
peacekeeping	operation
exasperation	annoyance
cyst	pathology
bat	club
neuter	gender
summon	call
abstract	see
rival	compete
manhattan	cocktail
pasta	food
ret	drench
situation	condition
mead	brew
quote	repeat
band	strip
compact	case
cock	put
command	skillfulness
contrary	opposition
sect	religion
marguerite	subshrub
drive	coerce
intro	passage
pock	pustule
color	timbre
intersection	point
bully	aggression
inducement	cause
context	environment
proxy	agent
boot	resuscitate
receipt	acknowledgment
heckle	comb
hero	character
sorcerer	occultist
kettle	pot
boxcar	twelve
partake	share
yank	pull
center	area
housework	work
viceroy	nymphalid
veteran	expert
publisher	owner
functionality	practicality
stockade	fortification
wavelength	orientation
represent	remonstrate
baton	rod
minister	executive
draft	sketch
dig	site
mummification	embalmment
rail	material
horn	pommel
king	sovereign
flurry	snow
installation	begin
teaspoon	containerful
tag	rhyme
cinnamon	spice
wind	distress
bandstand	platform
disrespect	see
grasp	understand
imperfection	state
call	demand
constitution	property
bracket	support
ninety	decade
steppe	plain
reunite	meet
ebb	decline
rudd	cyprinid
matron	nurse
figure	shape
find	perceive
disadvantage	discriminate
cab	car
negligence	nonaccomplishment
streamline	contour
library	depository
julienne	vegetable
settle	arrange
sagittarius	person
gazelle	antelope
prostitute	sell
employment	state
vegetable	produce
garter	fasten
abnormality	unfamiliarity
viaduct	bridge
devour	eat
match	light
elephant	emblem
glow	radiate
exhibition	presentation
sensibility	sensitivity
center	move
have	score
cob	swan
story	fiction
ring	sound
snout	nose
cake	block
stagecraft	craft
blower	device
hit	approach
leukemia	cancer
grade	measure
zinfandel	vinifera
break	decay
even	day
downbeat	rhythm
seed	fruit
intifada	rebellion
stare	look
septet	set
prick	hurt
nylon	stock
bicentennial	anniversary
pacifier	thing
riff	play
relieve	take
call	visit
principal	financier
conservative	adult
outflank	travel
assassin	murderer
backup	accretion
plow	travel
thread	cord
apprentice	train
tube	conduit
pipe	cylinder
concede	agree
barrel	put
submerge	cover
environmentalist	reformer
orgy	indulgence
bennet	avens
takeover	buyout
work	move
build	structure
favor	inclination
flag	collection
trim	decorate
catechism	interrogation
divergence	series
pin	leg
kidnapper	captor
phase	synchronize
transformation	function
downhill	descent
cereal	grass
reimposition	imposition
grief	sorrow
decorum	propriety
fit	be
carpentry	trade
studio	workplace
gape	be
chancery	court
menace	danger
clog	footwear
production	presentation
range	be
stilt	shorebird
autopilot	device
deep	middle
carpenter	woodworker
igbo	nigerian
elude	escape
yuan	dynasty
steady	stabilize
morphine	analgesic
flood	flow
bus	dysphemism
buff	device
genie	spirit
annoyance	mistreatment
description	kind
median	average
leotard	garment
tee	peg
picture	imagination
demonstrator	salesperson
joiner	member
grey	organization
heave	movement
basque	european
pancake	cake
mushroom	basidiomycete
rescuer	person
parrot	copycat
imperial	baggage
motherhood	kinship
library	room
beast	attacker
dress	pare
pupil	aperture
branch	division
masturbation	autoeroticism
scrimmage	exercise
graze	abrasion
alloy	mixture
check	crack
spur	goad
handicap	bias
approach	come
guess	solve
decline	condition
austerity	self-discipline
orderly	soldier
yell	shout
performance	accomplishment
scribble	write
hold	think
concourse	hallway
bolt	bar
revitalize	regenerate
desert	consequence
upset	arouse
approval	like
buff	leather
shower	descent
deserter	wrongdoer
lion	celebrity
bandage	dress
defend	prevent
steal	take
tattoo	design
incineration	burn
drawbridge	bridge
snip	shear
vanilla	relish
demeanor	trait
ambition	drive
robbery	larceny
wallow	indulge
redneck	rustic
arrival	action
timber	post
duce	leader
stem	orient
spike	increase
referendum	vote
damnation	denunciation
break	separation
cranberry	berry
pardon	forgive
refer	send
prominence	stand
weed	remove
cup	punch
wildcat	cat
cut	decrease
surf	wave
indemnity	exemption
attraction	show
cairn	terrier
tax	strain
depose	oust
touchdown	score
airlift	transportation
want	be
outdoors	outside
atom	substance
donate	give
squawk	noise
wet	make
composition	placement
carmine	redden
pass	throw
fill	hire
van	truck
pessimism	disposition
telegram	message
strike	solve
circulation	count
dove	pigeon
elector	prince
adversary	person
recipient	acquirer
chance	happen
blasphemy	profanity
winery	distillery
rework	work
situation	difficulty
bite	meal
leak	issue
overhead	ceiling
retort	answer
miller	shaper
musicianship	art
thumb	finger
poll	inquiry
desperate	unfortunate
indentation	space
butch	merchant
cutaway	coat
subscription	contribution
dummy	figure
gravel	rock
royal	sail
castration	operation
primo	part
end	point
acid	compound
web	weave
rule	restrict
preview	watch
clock	quantify
juror	panelist
tabor	drum
roulette	wheel
walker	shoe
maneuver	operation
widen	increase
brush	touch
calculate	intend
tort	wrongdoing
enamel	compound
southwest	location
ephedra	shrub
bark	tan
natural	cast
forge	travel
malt	convert
monogamy	marriage
buffalo	game
cock	bird
retain	prolong
life	motivation
minister	diplomat
bend	grass
cast	bandage
liquor	liquid
brief	underpants
mold	dish
dereliction	negligence
wariness	circumspection
fascination	attraction
fez	cap
cocoa	beverage
irritate	stimulate
ballad	song
set	abstraction
daze	confusion
soviet	state
pepper	flavorer
cotton	like
compromise	cooperation
leaf	sheet
sabra	israeli
compilation	collection
eurasian	european
instrument	address
crescent	curve
defense	justification
shoe	footwear
span	distance
hail	be
jet	airplane
bead	form
visualize	imagine
codeine	antitussive
column	array
perspiration	secretion
constant	number
lug	projection
lap	flap
musical	play
instinct	aptitude
leopard	fur
schematic	diagram
boundary	line
antibody	protein
preemption	appropriation
contest	oppose
track	artifact
entrench	fasten
salaam	bow
tilt	position
aryan	primitive
surrey	carriage
hit	affect
wallpaper	cover
bankrupt	failure
heart	intuition
course	education
aorta	artery
inflame	arouse
treason	disloyalty
make	perform
hopi	pueblo
rum	liquor
stall	delay
defensive	attitude
tidy	receptacle
sunglass	spectacle
prohibition	action
consolation	relief
carrier	deliveryman
person	populate
redeem	restore
submit	yield
point	tag
punch	tool
precipitate	solid
matriarch	woman
puff	gust
bath	vessel
raid	embezzlement
impart	tell
reassure	calm
sacrifice	loss
incident	disturbance
speller	primer
flat	plain
opinion	message
spillover	consequence
focus	sharpen
descent	slope
directive	pronouncement
crick	twist
birdie	shoot
strip	lumber
pee	micturition
tune	pitch
arrange	agree
jet	discharge
striker	nonworker
haircut	hairdo
intern	confine
reseda	herb
realpolitik	politics
leapfrog	jump
tuesday	weekday
ham	actor
pentagon	bureaucracy
clear	clarify
fabrication	construction
alfalfa	medic
walk	path
pride	feel
dugout	shelter
intoxication	exhilaration
varnish	coat
surrender	yield
vamp	patch
quantification	restriction
implosion	blockage
sale	occasion
thinness	consistency
skater	athlete
agitator	troublemaker
closure	order
piggyback	ride
americanism	formulation
fringe	decorate
change	happen
cancellation	nullification
gavel	mallet
marsh	wetland
rubric	title
sled	ride
knit	fabric
detachment	separation
deceleration	speed
washroom	toilet
histamine	amine
bristle	hair
weekly	series
dust	particulate
reel	winder
brunet	person
bunker	fuel
mr	title
strum	sound
rush	flow
enterprise	drive
conduct	perform
haze	overcast
curtain	supply
nunnery	convent
ethnicity	quality
choir	sing
judgment	trait
medicine	drug
swallow	believe
rue	herb
draft	pull
nomad	wanderer
perishable	foodstuff
founder	originator
perimeter	line
polymerase	enzyme
accessory	criminal
delay	wait
liquor	alcohol
multiply	increase
snipe	gunfire
wardrobe	collection
pair	group
repel	fight
ebb	besiege
gallery	audience
precipitation	acceleration
bow	reverence
ferry	bring
close	reliever
scrape	fragment
dunk	shoot
interferon	antiviral
yip	cry
grieve	afflict
haft	handle
plotter	clerk
take	undergo
advance	mover
say	recite
play	exploit
jumble	cake
reasonableness	wisdom
suppressor	gene
rosewood	tree
typify	mean
exert	use
teak	wood
slouch	incompetent
indication	name
letter	owner
anus	orifice
nightingale	thrush
bury	lie
marc	brandy
gynecology	medicine
cope	act
israeli	asian
rub	irritate
cable	rope
horror	thing
arbiter	expert
list	register
attest	affirm
find	reason
smoothness	texture
basket	containerful
fill	repair
compress	tighten
piccolo	flute
review	remember
loner	individualist
quill	pen
shame	dishonor
stick	lever
minuscule	longhand
converter	device
apnea	symptom
net	catch
starboard	steer
leftover	remainder
shill	coin
look	appearance
parlay	bet
shantytown	slum
beat	move
flock	travel
foul	dishonor
coffee	tree
whistle	sound
picket	detachment
cylinder	container
roundhouse	hook
bail	free
turn	transmit
gothic	font
pass	cycle
academy	school
envoy	stanza
herd	move
tone	interval
lettuce	herb
stimulation	arousal
cote	shelter
projection	representation
speak	sound
create	act
fit	manner
leap	jump
berm	ledge
waterproof	fabric
voice	adjustment
fender	barrier
partridge	phasianid
stay	strip
sternum	bone
mix	compound
rebuff	rejection
pollster	inquirer
potpourri	perfume
relish	condiment
fallout	dust
thoroughbred	racehorse
list	organization
biotechnology	engineer
thatcher	roofer
color	change
ignition	fire
unseat	move
smuggle	import
charmer	person
slate	roof
cut	division
head	originate
graduate	confer
officiate	perform
richness	shade
thunder	shout
nostril	naris
coat	overgarment
manifest	record
way	course
softball	baseball
confession	penance
ogle	look
word	formulation
mobilization	assembly
offer	supply
codeine	opiate
tiller	shoot
caste	class
recourse	aid
float	travel
college	body
margin	amount
climate	condition
ration	allotment
auditor	student
cross	path
neurosurgery	operation
branch	stream
match	join
bay	cry
crunch	chew
discount	decrease
community	gather
feed	provision
kuomintang	party
guarantee	assurance
board	committee
yuma	yuman
clean	remove
capitalize	write
crazy	lunatic
carrier	vector
rationalize	think
dermis	stratum
woodcock	shorebird
range	fee
maximum	extremum
dedicate	assign
junk	boat
disorder	change
assertion	declaration
value	worth
lyon	council
chancellor	principal
campsite	site
dainty	nutriment
pop	burst
friction	resistance
nip	clip
juke	joint
purification	ceremony
bail	guarantee
chirp	sound
beanie	skullcap
flight	fly
spotter	employee
sumo	wrestle
fuel	substance
crow	siouan
pace	travel
ark	boat
loyalty	love
name	appoint
darling	lover
savage	knock
scandinavian	germanic
drunk	drinker
level	destroy
airhead	simpleton
economy	system
endgame	end
pant	breathe
eyesore	ugliness
farmland	country
refocus	focus
bracelet	jewelry
bail	empty
choreographer	creator
square	position
fin	swim
assimilate	change
ring	betrothal
acknowledge	communicate
bop	jazz
quantify	carry
pheasant	flower
break	interrupt
vandal	savage
zambian	african
uphold	defend
stink	be
box	blow
derivative	compound
medium	environment
suspect	think
troll	circle
read	audition
lock	fasten
longevity	oldness
judo	sport
drug	consume
pack	load
apprenticeship	position
encephalitis	inflammation
mince	nutriment
yoke	pair
perform	re-create
dissolve	end
wig	hairpiece
heel	repair
inauguration	initiation
freshness	originality
fume	feel
account	be
pawnee	caddo
officer	command
stagnation	inaction
tune	music
devaluation	decrease
cookie	cake
crusade	expedition
slide	motion
board	departure
greed	desire
lap	drink
jog	provoke
joint	fit
chloroform	haloform
activate	change
sigh	utter
readjust	adjust
ani	cuckoo
payback	return
referral	recommendation
air	region
male	person
submarine	operate
suture	joint
assimilate	adjust
aerosol	cloud
coma	unconsciousness
referee	judge
code	encode
sack	bag
dispersion	spread
head	remove
cultivation	growth
drought	dryness
breed	produce
regret	inform
issue	content
derision	discourtesy
adhere	match
check	stop
delaware	algonquian
pelvis	girdle
antelope	bovid
fester	exhaust
hold	control
quarter	part
curl	twist
claim	request
caribou	deer
trim	machine
hen	chicken
sociopath	neurotic
prophesy	predict
airline	line
party	celebrate
zulu	nguni
fire	bake
toe	touch
buoy	mark
reconstruction	interpretation
checkmate	victory
crawler	person
recital	statement
variation	process
jam	conserve
purge	clean
clip	attach
pew	bench
purchase	influence
pearl	jewel
don	head
addiction	crave
incompatibility	contradictoriness
knot	fastener
adequacy	satisfactoriness
approximation	version
sissy	coward
batter	concoction
tilt	joust
double	person
appetite	crave
complaint	plead
basset	appear
vermin	pest
earth	grind
jealousy	watchfulness
chop	jaw
seneca	iroquoian
break	appear
gutter	burn
chain	unit
thrombosis	occlusion
flex	shrink
clincher	determinant
cause	origin
flume	watercourse
clap	hit
screw	revolve
gallery	corridor
popularize	gear
congressman	legislator
temple	feature
type	character
gingerbread	cake
cover	endow
burke	murder
kiss	cookie
cut	stroke
see	cut
utilize	change
entitle	name
knockout	blow
creation	begin
run	damage
shortstop	position
junior	upstart
attention	faculty
blueprint	design
talk	lecture
devotion	commitment
repulsion	force
notch	cut
hedonism	ethic
elude	perplex
bring	transport
categorize	reason
chow	spitz
militant	reformer
weapon	persuasion
rebroadcast	broadcast
narration	section
curb	edge
wash	streambed
segregate	person
rededication	dedication
carrion	body
absentee	traveler
cashier	abolish
appointee	official
suitability	quality
hole	defect
protection	security
bordeaux	wine
disco	ballroom
position	relation
label	marker
tie	restrict
defect	imperfection
airport	airfield
lodge	populate
catch	control
submit	refer
puncture	depressurize
microwave	cook
adder	viper
parishioner	churchgoer
allow	give
derelict	pauper
chapter	club
breed	socialization
lock	fastener
call	ask
reaffirm	affirm
tour	travel
receptacle	container
artery	thoroughfare
demagogue	politician
bin	store
fowl	hunt
plotter	instrument
bean	legume
chop	cut
alternate	act
engage	move
creation	artifact
puddle	shape
vandal	destroyer
electorate	citizenry
electrocardiogram	graph
decompose	decay
outfit	arm
rein	strap
abolition	termination
seduce	persuade
foil	attention
tenth	rank
infuse	inject
inadmissibility	unacceptability
tibetan	asian
kidnap	capture
place	cognition
luge	toboggan
blast	make
copper	lycaenid
sew	fasten
package	collection
desktop	top
engineer	design
farm	collect
plan	idea
prison	situation
sear	heat
oversimplification	simplification
stout	size
miracle	event
metropolitan	resident
quack	act
head	foam
chad	afroasiatic
rabbi	title
helix	curve
piece	creation
key	lever
point	characteristic
buck	endeavor
liqueur	alcohol
ping	sound
shift	substitute
preseason	season
lag	cover
hollywood	spirit
originator	creator
round	travel
bosom	hide
bomber	person
empty	container
underpass	tunnel
people	person
ripple	oscillation
dung	stool
apparition	appearance
dampen	weaken
canvas	set
paragon	ideal
chardonnay	vinifera
discharge	remove
product	chemical
referee	review
anthem	song
whey	serum
bias	prejudice
angel	patron
blink	reflex
toot	sound
sweeten	season
corrode	decay
arch	entrance
stimulant	drug
torpedo	firework
belly	inside
rip	cut
jeep	car
pap	drivel
compulsion	cause
sectarianism	narrow-mindedness
mousse	groom
deflate	decrease
feeder	animal
lubricate	be
ransom	payment
clean	deprive
revocation	state
clean	laborer
stipulation	restriction
illusion	misconception
lightning	flash
swing	play
shore	beam
element	situation
dictatorship	autocracy
security	fearlessness
flat	footwear
nitrate	process
beat	be
retool	reorganize
glide	flight
bowl	ball
blot	mistake
epinephrine	vasoconstrictor
occasion	reason
log	record
escort	accompany
sediment	settle
pusher	sandal
simplicity	naturalness
playmate	companion
smallpox	pox
clinch	hold
sleeper	pajama
poise	equilibrium
stasis	pathology
centrum	bone
iris	membrane
narcolepsy	hypersomnia
ironside	man
damage	change
colonial	resident
control	restrain
fink	work
refinance	finance
thing	feel
rota	court
transgress	disrespect
specialize	work
mandate	delegate
work	become
relay	operate
exude	express
gumbo	soil
separation	change
mister	title
