olympus	greece
dijon	france
frank	hotdog
puberty	adolescence
main	infrastructure
slovakia	europe
aileron	wing
arauca	colombia
ethiopia	africa
wardrobe	costume
handle	handset
refrain	song
countertop	counter
dermis	skin
england	europe
point	arrow
artwork	publication
aria	opera
tupelo	mississippi
gyroscope	gyrocompass
caucasus	caucasia
carbondale	illinois
acre	brazil
ventilator	ventilation
spout	pipe
para	brazil
spokane	washington
potsdam	germany
tibet	asia
blade	spatula
act	ballet
mouth	face
bowery	manhattan
laser	photocoagulator
orleans	france
embolism	calendar
piedmont	italy
ecclesiastes	hagiographa
tongue	mouth
sinai	egypt
mil	inch
provence	france
eyebrow	face
toe	hoof
rocker	cradle
sash	window
niger	guinea
mouth	jar
tour	france
point	knife
noose	lasso
stigma	style
scandinavia	europe
joshua	prophet
quarter	hundredweight
leipzig	germany
scoop	backhoe
kitchen	dwell
runway	airstrip
mosul	iraq
episode	serial
enid	oklahoma
head	coin
diffuse	lamp
sternum	thorax
arequipa	peru
fingernail	finger
andorra	europe
bogota	colombia
maxwell	weber
pier	bridge
detroit	michigan
aquarius	zodiac
even	night
leg	four-poster
victoria	seychelles
zanzibar	tanzania
column	temple
hemisphere	earth
jonah	prophet
montpelier	vermont
stratosphere	atmosphere
rhine	netherlands
retort	still
tuscaloosa	alabama
shoulder	torso
point	needle
barcelona	spain
bushel	quarter
lyric	song
marrakesh	morocco
sherman	colorado
gamma	oersted
petersburg	virginia
russia	eurasia
gram	dekagram
cabin	spacecraft
minster	monastery
marseille	france
augusta	georgia
kremlin	moscow
month	year
stylus	cartridge
jam	virginia
canberra	australia
grate	furnace
swaziland	africa
tunisia	maghreb
runway	airfield
superstructure	ship
hyderabad	pakistan
inning	cricket
stockholm	sweden
nose	aircraft
messina	sicily
kent	england
dayton	ohio
watt	horsepower
managua	nicaragua
incident	episode
duluth	minnesota
incubation	infection
turnaround	road
handle	briefcase
harrisburg	pennsylvania
reykjavik	iceland
brasilia	brazil
hagerstown	maryland
hindustan	india
avon	england
inlet	sea
combat	war
gauze	bandage
navel	abdomen
base	transistor
space	form
hatch	hatchway
hardware	computer
xian	china
richmond	virginia
concord	massachusetts
rockford	illinois
parana	brazil
verona	veneto
stock	gun
rome	italy
line	letter
columbus	mississippi
fluke	cetacean
part	whole
oaxaca	mexico
balance	account
barb	spear
willamette	oregon
lancaster	england
plumb	construction
subculture	culture
text	publication
gallon	barrel
osaka	honshu
mane	lion
circle	theater
soho	manhattan
gaskin	horse
malta	mediterranean
gallon	firkin
agora	shekel
fukuoka	japan
cornwall	england
huntsville	alabama
wausau	wisconsin
dortmund	germany
siberia	russia
kilimanjaro	tanzania
barbados	caribbean
invocation	service
canterbury	kent
prosecution	trial
personality	person
mansfield	ohio
tokyo	japan
gujarat	india
appendix	cecum
bathroom	dwell
lawrence	kansa
pyrenees	france
euphrates	iraq
toulouse	france
dusseldorf	germany
twin	snake
farmyard	farm
homework	education
galway	ireland
yellowstone	montana
stave	barrel
portland	maine
room	build
fresno	california
muncie	indiana
handle	handlebar
bulawayo	zimbabwe
iran	asia
hannibal	missouri
suriname	guiana
wilmington	delaware
pint	quart
maryland	south
horizon	profile
appleton	wisconsin
feature	face
stairway	build
segregation	meiosis
church	christendom
platte	nebraska
terminal	battery
yolk	egg
tube	circuit
nagano	honshu
beard	face
saddle	shoe
newcastle	england
guinea	africa
mattress	bed
gallon	bushel
bermuda	atlantic
band	garment
ankle	leg
masse	pool
matrix	bone
blade	windmill
magdalena	colombia
car	elevator
nanning	china
fixation	plastination
toledo	spain
niamey	niger
coral	lobster
volgograd	russia
installment	series
reef	sail
clichy	paris
midafternoon	afternoon
nashville	tennessee
casper	wyoming
phase	cycle
phalanx	digit
brindisi	italy
antenna	transmitter
gang	india
granada	andalusia
anchor	vessel
arch	wall
pendant	necklace
conclusion	narration
limb	octant
way	shipyard
cell	monastery
kabul	afghanistan
bell	blunderbuss
kilowatt	megawatt
athens	ohio
chechnya	russia
den	dwell
handle	faucet
foot	leg
ebb	ebbtide
eyre	australia
lift	heel
choke	circuit
thumbnail	thumb
margin	page
cuff	sleeve
marrow	bone
yard	perch
niger	benin
wick	candle
fleet	airline
bulb	syringe
pock	smallpox
saratov	russia
back	chair
northeast	east
biloxi	mississippi
grille	car
saskatchewan	canada
lesotho	africa
word	kilobyte
break	pool
california	southwest
valletta	malta
fukuoka	kyushu
reno	nevada
lock	canal
stake	pool
rabat	morocco
pentecost	whitsun
rhine	germany
mississippi	south
netherlands	europe
stage	theater
season	cook
weapon	weaponry
surface	lithosphere
hoop	hoopskirt
babylon	mesopotamia
keyboard	organ
elbe	europe
mane	homo
potomac	maryland
format	publication
movement	sonata
register	memory
kalahari	botswana
bait	trap
quart	gallon
strap	baggage
box	balcony
grain	pennyweight
goma	congo
subtitle	movie
twenty	adulthood
library	house
conclusion	address
dish	meal
cabin	liner
kashmir	india
characteristic	nature
dakar	senegal
peg	dinghy
kyoto	honshu
urethra	vulva
feature	magazine
joel	prophet
midland	texas
limb	tree
prong	fork
adana	turkey
face	head
strap	brassiere
wall	room
brownsville	texas
facial	face
berkshire	england
upstairs	build
indianapolis	indiana
red	oklahoma
isfahan	iran
ear	head
istanbul	turkey
placenta	uterus
ping	thailand
limb	sextant
rhodes	greece
job	hagiographa
jerusalem	israel
skeleton	aircraft
mcallen	texas
lexis	language
clutch	transmission
dehydration	plastination
buff	car
lock	door
vocabulary	language
kinshasa	congo
urals	russia
odessa	ukraine
square	checkerboard
bangladesh	asia
gobi	china
snake	oregon
tidewater	south
northwest	west
shelf	cabinet
palm	hand
milan	lombardy
helena	montana
ara	armenia
everglades	florida
breech	barrel
millimeter	centimeter
shasta	california
distribution	market
missoula	montana
hilo	hawaii
haft	dagger
appalachia	appalachian
ljubljana	slovenia
harness	parachute
reverse	car
kursk	russia
cent	dollar
lid	chest
miami	florida
gary	indiana
kurdistan	syria
pisa	tuscany
punjab	india
kathmandu	nepal
colorado	nevada
caledonia	scotland
credit	movie
stone	quarter
green	wyoming
greenland	atlantic
bennington	vermont
allegheny	virginia
portland	oregon
tyler	texas
lash	whip
medford	oregon
jamestown	virginia
see	diocese
reverse	coin
filler	forint
southwest	west
urbana	illinois
intersection	road
ruff	bridge
lucknow	india
porgy	scup
capri	campania
letter	spell
rotor	turbine
shiraz	iran
afghanistan	asia
cap	fungus
alberta	canada
sector	block
character	personality
keyboard	typewriter
sur	lebanon
perch	furlong
dachau	germany
oman	asia
brush	generator
till	farm
pace	walk
blade	sword
palau	pacific
leon	mexico
mouth	bottle
destiny	supernatural
portsmouth	virginia
selma	alabama
vichy	france
livonia	latvia
postscript	letter
bamako	mali
movement	clock
georgia	south
sura	koran
handle	teacup
attic	entablature
hilt	dagger
columbia	canada
kurdistan	turkey
handle	handbarrow
charge	indictment
box	coach
skeleton	ship
antalya	turkey
tennessee	kentucky
aire	england
constantine	algeria
chuck	drill
pocket	garment
read	berkshire
pocatello	idaho
vietnam	indochina
ray	fin
blade	ax
superior	wisconsin
brim	vessel
quebec	canada
chattahoochee	georgia
andes	argentina
gadsden	alabama
victoria	texas
lace	shoe
hierarchy	administration
past	life
lock	gate
shreveport	louisiana
haft	ax
delphi	greece
pedestal	column
bern	switzerland
mackenzie	canada
samaria	palestine
burlington	vermont
judah	palestine
waterloo	belgium
predictor	antiaircraft
yokohama	honshu
centimeter	decimeter
night	day
shaft	tunnel
bhutan	asia
broomstick	broom
vanuatu	melanesia
mekong	lao
paint	construction
antenna	receiver
dushanbe	tajikistan
sahara	africa
tangy	morocco
gem	jewelry
kivu	congo
bell	funnel
helsinki	finland
arch	bridge
remedy	treatment
columbus	ohio
midstream	stream
keyboard	piano
knee	leg
back	framework
midway	carnival
nile	egypt
rod	retina
point	pencil
keep	castle
bind	book
amman	jordan
waco	texas
thwart	dinghy
jonesboro	arkansas
bighorn	montana
malacca	rattan
spain	europe
savoy	switzerland
dodoma	tanzania
asmara	eritrea
keel	carinate
nassau	bahamas
ur	sumer
plea	trial
don	russia
heirloom	inheritance
fibrosis	pneumoconiosis
roof	build
taurus	zodiac
adriatic	mediterranean
break	billiards
taxiway	airfield
crown	hat
andes	colombia
shutter	camera
hay	kansa
cheddar	england
fulcrum	lever
moline	illinois
fuselage	airplane
anchorage	seaport
nome	alaska
venturi	carburetor
syracuse	sicily
cannes	france
feather	row
cheek	face
ukraine	europe
crown	road
shenyang	china
adam	cascade
shelf	etagere
redding	california
gear	engine
quill	feather
warp	weave
wither	ox
hamilton	ontario
bumper	car
mandalay	myanmar
riviera	france
quadriceps	thigh
lincoln	nebraska
tortilla	wrap
ardennes	champagne
columbia	tennessee
cambridge	england
papeete	tahiti
playback	recorder
monongahela	pennsylvania
bridge	nose
centrum	vertebra
tabasco	mexico
blade	oar
hippo	algeria
visor	helmet
symptom	disease
aggression	war
lhasa	tibet
norfolk	virginia
edmonton	alberta
roof	truck
monterrey	mexico
shelf	closet
rhone	switzerland
tooth	gear
danube	austria
head	body
timbuktu	mali
mantel	fireplace
danube	germany
arkansas	colorado
manitoba	canada
sudan	africa
handle	handcart
floor	exchange
abadan	iran
inch	foot
trait	personality
responsibility	character
po	italy
peck	bushel
klondike	yukon
palate	mouth
beaver	helmet
sen	rupiah
beef	cattle
jurassic	mesozoic
cologne	germany
gore	gaiter
cornerstone	build
ban	leu
bay	aircraft
exaltation	zodiac
pennsylvanian	carboniferous
sherman	texas
juneau	alaska
antioch	turkey
rudder	vessel
foot	yard
spread	publication
roof	bus
baku	azerbaijan
aries	zodiac
hale	koruna
hip	thigh
shunt	circuit
linz	austria
davenport	iowa
socket	bone
monaco	europe
bridge	spectacle
chelyabinsk	russia
chip	computer
university	academia
eyelid	eye
vilnius	lithuania
shanghai	china
primo	duet
wither	horse
nagasaki	japan
chennai	india
low	cyclone
nunavut	canada
handle	cutlery
movement	watch
sea	hydrosphere
perch	roost
clinton	iowa
quart	peck
lip	mouth
log	ship
loin	homo
sleeve	garment
negev	israel
chartres	france
valve	brass
book	text
tonga	polynesia
gill	pint
epilogue	write
bordeaux	france
vientiane	lao
arrowhead	arrow
denmark	jutland
fuji	japan
aberdeen	washington
face	animal
shoulder	garment
taipei	taiwan
step	stairway
brandenburg	prussia
promotion	market
france	europe
birmingham	alabama
epiphany	january
victoria	zambezi
point	sword
brescia	italy
hanukkah	kislev
savannah	georgia
georgetown	guyana
arcadia	greece
seesaw	playground
laredo	texas
madagascar	africa
foot	homo
shelf	bookcase
underpants	pantyhose
eyepiece	sight
beach	shore
ob	siberia
clasp	bracelet
kissimmee	florida
pfennig	mark
orlando	florida
handle	ladle
pontoon	amphibian
guadalajara	mexico
hampshire	england
proverb	hagiographa
georgia	transcaucasia
prong	trident
mongo	tugrik
shank	nail
utica	phoenicia
constituent	sentence
avignon	france
ounce	pound
izmir	turkey
grain	decigram
shift	workday
wrinkle	skin
caste	colony
savoy	france
cordoba	spain
devon	england
shank	wineglass
mesh	inch
blowfish	puffer
kazakhstan	asia
zaragoza	spain
snake	washington
handle	aspergill
flag	dog
chad	africa
heel	foot
yemen	asia
judaism	jewry
head	ram
cannon	tank
thessaloniki	greece
shoulder	chuck
rwanda	africa
noon	day
audio	television
ceiling	hallway
colorado	mexico
trotter	sheep
applause	ovation
wembley	london
tongue	boot
sign	disease
sana	yemen
atom	molecule
quill	porcupine
capitol	washington
casablanca	morocco
apron	airfield
roof	car
pakistan	asia
dubuque	iowa
chernobyl	ukraine
slaughter	butchery
karnataka	india
hemisphere	cerebrum
death	life
orchestra	theater
arc	sector
heel	boot
hearth	fireplace
samarkand	uzbekistan
wing	bird
andalusia	spain
diarrhea	dysentery
medan	sumatra
blade	turbine
jordan	asia
stretch	racetrack
nagasaki	kyushu
novgorod	russia
suspension	car
mogadishu	somalia
iceland	europe
ionosphere	atmosphere
xinjiang	china
chittagong	bangladesh
rabbit	hare
windhoek	namibia
rosario	argentina
charlestown	boston
danube	bulgaria
torah	tanakh
basis	explanation
cancer	zodiac
ball	hand
mekong	cambodia
niger	nigeria
boise	idaho
solomon	melanesia
rhyme	poem
bangalore	india
continent	europe
prism	spectroscope
brattleboro	vermont
banff	alberta
houston	texas
cerebellum	hindbrain
mesopotamia	iraq
cameroon	africa
nevada	southwest
hook	grapnel
honolulu	oahu
palermo	sicily
calais	france
clause	sentence
bartlesville	oklahoma
faisalabad	pakistan
somerset	england
section	citrus
blida	algeria
khartoum	sudan
floor	cave
variety	specie
pasture	country
helm	tugboat
fin	fish
carriage	lathe
knob	hilt
forte	sword
trench	entrenchment
tooth	comb
knot	board
eureka	california
georgetown	washington
introduction	narration
frankfort	kentucky
rumble	carriage
mobile	alabama
gill	cup
burundi	africa
jiao	yuan
mekong	thailand
window	build
gettysburg	pennsylvania
niagara	ontario
sight	firearm
paragraph	text
sole	foot
somalia	africa
register	furnace
luoyang	china
nucleus	comet
shank	handle
weekend	week
mouthpiece	telephone
mongolia	asia
arlington	texas
scatter	extinction
rawalpindi	pakistan
battle	war
nauru	micronesia
seaport	seafront
amplifier	stereo
crotch	body
seattle	washington
nose	missile
ohm	megohm
pulp	tooth
sunbeam	sunlight
kurd	kurdistan
nipple	bottle
murray	australia
bolt	lock
action	keyboard
small	back
mesa	arizona
nape	neck
cascade	northwest
westminster	london
point	arrowhead
rapid	river
white	missouri
thigh	leg
em	inch
abdominal	abdomen
teen	adulthood
bench	court
spur	boot
flower	angiosperm
guangzhou	china
islamabad	pakistan
eindhoven	netherlands
electrocardiogram	checkup
verse	poem
susanna	apocrypha
term	proposition
colorado	texas
surrey	england
ogden	utah
bathtub	bathroom
sarasota	florida
deck	ship
stock	artillery
helm	ship
olympia	washington
leg	chair
keystone	arch
sen	yen
volga	russia
bottom	inning
mojave	arizona
cadiz	spain
nepal	asia
wiper	rheostat
forearm	arm
gdansk	poland
bloomington	indiana
skopje	macedonia
tread	step
sell	market
cambodia	indochina
haft	knife
nagoya	honshu
bodyguard	cortege
lewiston	idaho
flank	quadruped
slam	bridge
japan	asia
tabletop	table
hand	arm
jeremiah	prophet
territorial	militia
liege	belgium
rampart	fortification
cranium	skull
face	homo
abdomen	torso
beet	beetroot
luanda	angola
open	surface
hannover	germany
osage	missouri
annapolis	maryland
hertz	kilohertz
phone	utterance
bighorn	wyoming
sauce	dish
piedmont	south
lahore	pakistan
judge	prophet
drumstick	bird
antananarivo	madagascar
cotonou	benin
leg	table
kalahari	namibia
stamp	battery
klamath	california
corolla	perianth
pork	hog
blow	fight
omaha	nebraska
ovary	flower
electrode	tube
brace	framework
century	millennium
asia	eurasia
memphis	tennessee
bedroom	dwell
yorktown	virginia
course	wall
pedal	organ
seine	france
strap	chemise
eye	needle
assault	attack
red	louisiana
minneapolis	minnesota
cracow	poland
stump	tree
mon	vulva
farmington	connecticut
tigris	turkey
rule	book
cincinnati	ohio
layer	laminate
quark	hadron
hebei	china
bellingham	washington
nogales	arizona
liner	garment
case	window
zagreb	croatia
lid	box
greece	europe
herat	afghanistan
yakima	washington
arauca	venezuela
hoop	barrel
checkerboard	chess
envelope	balloon
galley	ship
beira	mozambique
amos	prophet
capillary	thermometer
fibula	leg
penobscot	maine
finale	performance
haft	file
dawson	yukon
antiquity	history
laramie	wyoming
gumbo	okra
queensland	australia
gabon	africa
portugal	europe
springfield	massachusetts
edge	fabric
phoenix	arizona
urethra	penis
stern	ship
fireplace	chimney
marrow	marrowbone
angola	africa
manchuria	china
leg	trouser
