nogales	town
fiedler	conductor
drake	navigator
fletcher	dramatist
guggenheim	philanthropist
galbraith	economist
brest	port
tobago	island
anderson	dramatist
versailles	city
akron	city
sapir	anthropologist
versailles	palace
tunney	prizefighter
don	river
webster	politician
hoover	lawyer
missouri	river
burroughs	inventor
wagner	architect
wiesel	writer
freud	neurologist
hay	actress
nancy	city
leigh	actress
frisch	economist
ward	businessman
scott	slave
sartre	dramatist
dunkirk	port
pavarotti	tenor
braille	educator
stevens	psychophysicist
cam	river
chittagong	port
bangalore	city
benny	comedian
conrad	writer
ney	general
birmingham	city
hirschfeld	artist
nobel	philanthropist
whitman	missionary
hargreaves	inventor
fairbanks	actor
tucker	comedienne
oswald	assassin
tupelo	town
mull	island
vichy	town
hall	explorer
clive	statesman
major	statesman
frost	poet
baltic	sea
fry	painter
barrie	dramatist
sousa	bandmaster
genesis	book
scope	schoolteacher
young	physicist
antigua	island
agra	city
mosaic	browser
shawn	choreographer
jam	apostle
dayan	general
hale	astronomer
herschel	astronomer
bruce	king
brown	abolitionist
ruth	book
pompadour	marchioness
rossini	composer
hellman	dramatist
blida	city
noah	patriarch
thalia	muse
basel	city
moses	prophet
nehru	statesman
saratov	city
stern	violinist
columbia	town
calvary	hill
neruda	poet
herman	bandleader
baikal	lake
marquis	humorist
pasteur	biologist
churchill	general
robert	parliamentarian
bavaria	state
lexington	city
gordimer	writer
weber	composer
mccartney	songwriter
morgan	pirate
maldives	island
cyprus	island
mandalay	city
ram	king
olympia	plain
hitler	nazi
machiavelli	statesman
hague	city
singer	inventor
jonah	book
vargas	statesman
meir	statesman
toulouse	city
morris	statesman
luce	dramatist
defoe	writer
wilde	dramatist
hokkaido	island
spengler	philosopher
marsh	writer
leonard	writer
versace	couturier
sinatra	crooner
agrigento	town
goethe	poet
baruch	disciple
higginson	writer
trotsky	bolshevik
jordan	river
clemens	humorist
durante	comedian
jam	river
john	apostle
ross	explorer
franklin	scientist
dallas	city
mach	physicist
grappelli	violinist
portsmouth	city
heinz	industrialist
bunyan	writer
bering	navigator
willard	dry
grant	painter
wolfe	writer
mubarak	statesman
cartier	navigator
howells	writer
hopkins	theologian
rogers	dancer
secretariat	thoroughbred
sperry	inventor
taurus	constellation
pasteur	chemist
cooke	financier
nightingale	nurse
republican	river
todd	chemist
wilson	entomologist
jeffers	poet
yucatan	peninsula
wheel	city
lindbergh	aviator
whistler	painter
ford	writer
proust	novelist
piston	composer
australia	continent
sapir	linguist
coventry	city
landau	physicist
pompey	general
oaxaca	city
hamilton	port
hart	dramatist
mogadishu	port
humboldt	naturalist
white	writer
byrd	organist
kursk	city
osage	river
drake	admiral
prescott	town
iceland	island
choose	korea
houdini	escapologist
porto	port
israel	country
hamilton	lady
gobi	desert
aden	city
fuji	volcano
inca	community
singapore	island
owen	athlete
marti	revolutionist
cornwall	county
paul	apostle
ezra	copyist
dylan	singer
oates	conspirator
thomas	poet
jackson	writer
kirchner	painter
reynolds	painter
columbus	navigator
bryan	lawyer
gould	paleontologist
machiavelli	philosopher
ishmael	patriarch
basra	city
antony	general
dewey	educator
balthazar	sage
polo	traveler
huntington	city
toscanini	conductor
kandinsky	painter
europe	continent
aragon	district
john	evangelist
valdosta	town
white	river
carver	chemist
lardner	writer
jam	criminal
valencia	city
phoebe	titaness
west	writer
gdansk	city
yeats	poet
london	writer
calais	port
musial	ballplayer
westinghouse	inventor
leonardo	sculptor
sinai	peninsula
cline	geneticist
lot	jew
cebu	city
brecht	dramatist
greene	writer
john	book
loo	architect
okeechobee	lake
grenada	country
verner	philologist
woolworth	businessman
styx	river
smith	sculptor
hannover	port
gilbert	doctor
laramie	town
confucius	philosopher
cheever	writer
caspian	lake
khachaturian	composer
low	cartoonist
tudor	dancer
allen	soldier
irving	writer
lindsay	poet
spenser	poet
evans	anatomist
harvey	scientist
braun	mistress
schumann	pianist
lausanne	city
delilah	mistress
plato	philosopher
harris	marshal
xavier	missionary
papeete	city
dia	navigator
mantle	ballplayer
seattle	city
camelot	capital
erin	ireland
tamale	city
ford	industrialist
bozeman	town
mill	philosopher
burgess	writer
moore	comedian
service	writer
marceau	mime
portsmouth	port
martin	singer
charles	river
messina	city
wharton	writer
boyle	chemist
eureka	town
thornton	architect
gandhi	statesman
pocahontas	powhatan
moon	satellite
jolson	singer
opel	industrialist
andes	range
adenauer	statesman
gulu	city
garrison	abolitionist
truth	abolitionist
locke	philosopher
nice	city
cagney	actor
athens	town
morley	chemist
saginaw	town
smut	soldier
behrens	architect
hastings	town
daimler	engineer
kosovo	state
hannibal	town
wilson	writer
mantegna	engraver
lincoln	lawyer
gluck	composer
suez	city
rasmussen	explorer
toyota	city
green	river
cabot	navigator
lufkin	town
orlando	city
pegasus	constellation
portland	city
alexander	conqueror
alfred	king
middleton	pamphleteer
cork	port
yakima	town
goldsmith	writer
andrew	apostle
yukon	district
citation	thoroughbred
pavlov	physiologist
sinatra	actor
asimov	writer
indus	constellation
ringling	showman
calvin	chemist
weber	painter
waco	city
moynihan	educator
cotonou	city
wolf	composer
hussein	king
leakey	anthropologist
eliot	writer
ithaca	island
cincinnati	city
ferdinand	king
huggins	astronomer
tate	critic
ur	city
fez	city
vizcaino	explorer
crater	constellation
kalamazoo	town
baraka	writer
franklin	printer
turner	endocrinologist
nasser	statesman
bangor	town
rostock	city
bloomfield	linguist
paul	feminist
sussex	county
mitchell	dancer
luzon	island
zimbalist	violinist
monroe	town
gallup	town
nijinsky	dancer
america	land
pizarro	conquistador
marshall	actor
sabin	microbiologist
clio	muse
hendrix	guitarist
rachmaninoff	pianist
father	hypostasis
korea	peninsula
didion	writer
livermore	suffragist
joffrey	choreographer
benton	legislator
mauritius	country
mannheim	city
calder	sculptor
vidal	writer
pythagoras	mathematician
cochise	apache
shari	river
tudor	choreographer
indonesia	country
chavez	composer
reich	analyst
rushdie	writer
vancouver	city
luanda	port
kandahar	city
crawford	actress
winslow	settler
seeger	poet
hopkins	financier
sully	statesman
bartlesville	town
joseph	carpenter
kinsey	zoologist
bougainville	island
jude	saint
houston	general
nantucket	island
mane	prophet
gang	river
leon	city
castro	socialist
timbuktu	city
leo	constellation
lin	architect
taif	city
morrison	writer
lazarus	beggar
shakespeare	dramatist
rittenhouse	astronomer
upjohn	architect
carnegie	philanthropist
shaw	writer
parkersburg	city
hirohito	emperor
guest	journalist
lemmon	actor
streep	actress
jacob	doctor
borodin	composer
excalibur	sword
otis	inventor
balkan	range
sun	star
vesey	insurgent
mosul	city
texarkana	town
gujarat	state
trotsky	revolutionist
odessa	city
hoffmann	architect
hilo	town
doha	port
siemens	engineer
guthrie	songwriter
negev	desert
cash	singer
williams	singer
dickinson	poet
hughes	aviator
pittsburgh	city
regency	rule
syracuse	siege
vidalia	town
burn	vaudevillian
vesuvius	volcano
langley	astronomer
ivanov	choreographer
meredith	novelist
antioch	town
marx	economist
morgan	anthropologist
omaha	thoroughbred
hertz	physicist
hattiesburg	town
damon	friend
butler	writer
auckland	port
willis	neurologist
baltimore	port
naomi	mother-in-law
homer	painter
soweto	city
weld	abolitionist
davenport	city
rupert	prince
draco	athenian
kobe	port
lasso	composer
salk	virologist
wilkinson	chemist
mccormick	tenor
christie	writer
sanchez	terrorist
rockwell	illustrator
runyon	writer
salzburg	city
scripps	publisher
gibraltar	promontory
napoleon	emperor
tocqueville	writer
lin	sculptor
astaire	dancer
freud	analyst
wheatley	poet
strickland	architect
huntington	businessman
gent	city
beckett	writer
scott	actor
chagall	painter
williams	ballplayer
socrates	philosopher
asia	continent
algiers	port
jackson	town
cork	city
doctorow	writer
kean	actor
kazan	director
hannibal	general
gibbon	historian
davis	painter
thatcher	stateswoman
modigliani	painter
morris	suffragist
leicester	city
titan	satellite
molotov	statesman
borneo	island
singer	manufacturer
rothschild	banker
bunyan	preacher
caesar	statesman
fatima	muslim
sunderland	town
verdi	composer
steichen	photographer
wayne	actor
mathias	athlete
thomas	apostle
schumann	composer
glenn	senator
frick	industrialist
lawrence	writer
ambrose	bishop
marini	poet
henry	chemist
bologna	city
bayonne	city
leary	psychologist
arno	river
petersburg	campaign
ufa	city
macleod	physiologist
portsmouth	town
campbell	mythologist
spokane	city
blantyre	city
tecumseh	shawnee
vonnegut	writer
osborne	dramatist
bridgeport	city
audubon	artist
wayne	general
revere	silversmith
rasputin	starets
chartres	town
mead	philosopher
rutherford	chemist
leakey	paleontologist
houston	port
oviedo	city
yokohama	port
cunningham	choreographer
rubinstein	pianist
thurber	cartoonist
somerset	county
waterbury	city
boulder	town
rawalpindi	city
tobey	painter
purcell	organist
sperry	engineer
aegean	sea
morgan	biologist
hamilton	mathematician
samoa	country
norman	soprano
mill	architect
sparta	city
samoa	island
joseph	patriarch
stalin	communist
malone	scholar
alger	writer
warburg	biochemist
brooklyn	borough
charlotte	city
stanley	inventor
mark	gospel
burke	statesman
rama	avatar
chamber	architect
rachmaninoff	composer
washington	educator
porto	city
graham	choreographer
bell	painter
lovell	astronomer
whitney	inventor
bach	organist
blacksburg	town
burton	explorer
hubbard	writer
israel	kingdom
keller	lecturer
berkeley	philosopher
dempsey	prizefighter
astaire	choreographer
lauder	comedian
dubrovnik	city
french	sculptor
marsh	painter
grave	writer
medan	city
webb	sociologist
hammerstein	lyricist
kwangju	city
stein	writer
carter	egyptologist
galen	anatomist
rosario	city
benedict	saint
bank	botanist
micah	prophet
morse	painter
manhattan	borough
judith	book
williams	settler
streisand	singer
aire	river
more	statesman
cornell	actress
grove	general
lafayette	town
tiffany	artist
mccarthy	writer
bronx	borough
mekong	river
martin	comedian
lisbon	port
housman	poet
transylvania	region
haber	chemist
gielgud	actor
segovia	guitarist
goodyear	inventor
arnold	traitor
kaunda	statesman
brighton	city
matthew	book
cotonou	port
armageddon	battlefield
updike	writer
greenland	island
bragg	general
worcester	city
seller	actor
duvalier	dictator
keats	poet
allen	actor
dunkirk	town
bryan	politician
inge	dramatist
stevens	poet
barbados	island
mindanao	island
tutu	archpriest
rockefeller	philanthropist
clemens	writer
markov	mathematician
luke	apostle
nestor	counselor
utrecht	city
allegheny	range
price	soprano
morgan	soldier
cain	man
smith	suffragist
raffle	administrator
natal	port
stella	painter
rhea	titaness
warren	writer
weber	conductor
sartre	existentialist
arkansas	river
mansfield	town
gibran	writer
russell	astronomer
bordeaux	port
gettysburg	town
jam	psychologist
duluth	port
hull	diplomat
isfahan	city
pollock	painter
augustine	theologian
swanson	actress
robinson	actor
stone	feminist
cologne	city
vega	dramatist
trumbull	poet
morris	financier
ross	dressmaker
terry	actress
pulitzer	publisher
parkinson	surgeon
dylan	songwriter
warhol	painter
wyatt	poet
pyramid	memorial
burk	frontierswoman
vicksburg	town
bailey	singer
crosby	crooner
joplin	composer
persia	empire
bacon	statesman
saba	island
potomac	river
indus	river
rankin	suffragist
albee	dramatist
burn	comedian
columbia	river
sully	painter
sherman	general
dubrovnik	port
brancusi	sculptor
krasner	painter
palau	country
macao	possession
baryshnikov	dancer
pueblo	city
attila	king
haworth	biochemist
taiwan	island
arlington	city
dakar	port
meade	economist
becket	saint
kyd	dramatist
shaw	bandleader
elbe	river
saxe	marshal
land	industrialist
cali	city
farmington	town
carnegie	educator
rock	gynecologist
hamilton	statesman
picasso	sculptor
chester	city
bordeaux	city
gray	botanist
milwaukee	city
shawn	dancer
wagner	composer
milan	city
nazareth	town
hillary	mountaineer
xinjiang	state
hull	port
sullivan	psychiatrist
peabody	educator
black	actress
well	writer
lander	town
darling	river
tuscaloosa	town
frisch	zoologist
hilbert	mathematician
bennington	town
adrian	physiologist
peary	explorer
carew	poet
hyperion	titan
caspar	sage
solomon	king
altoona	town
mark	book
caldwell	writer
mott	suffragist
keaton	comedian
bergman	actress
limerick	port
cadiz	port
nicholas	saint
lear	humorist
holly	songwriter
allen	comedienne
russell	writer
matamoros	city
howe	suffragist
eyre	lake
wimbledon	suburb
neva	river
brown	inventor
wilderness	forest
abel	man
volga	river
karnataka	state
post	aviator
ruth	wife
villard	businessman
jesus	son
guinness	actor
hangzhou	city
shannon	engineer
girard	financier
newport	city
frederick	town
jarrell	poet
martin	bishop
hero	mathematician
session	composer
galway	city
burbank	horticulturist
essex	county
erasmus	theologian
gwynn	comedienne
willamette	river
ecclesiastes	book
zealand	island
mansfield	writer
trumbull	painter
grass	writer
clausewitz	general
muncie	town
gilbert	physicist
sevilla	port
more	writer
havel	statesman
nation	dry
jeddah	city
tharp	choreographer
henson	puppeteer
brunswick	town
rostov	port
moore	poet
agee	novelist
chihuahua	state
cumberland	general
mao	revolutionist
wood	actress
chamberlain	statesman
dodoma	city
schweitzer	missionary
dewar	physicist
medford	town
atlanta	siege
lawrence	painter
hogg	poet
powell	physicist
sax	maker
crouse	dramatist
doris	region
split	city
fayetteville	town
lamb	essayist
jam	writer
taiyuan	city
nielsen	composer
susquehanna	river
hiroshima	city
tatum	biochemist
dubuque	town
greenville	town
cummings	writer
mann	writer
monaco	principality
gray	navigator
oldenburg	sculptor
nuremberg	city
george	martyr
saul	king
christchurch	city
indochina	peninsula
lewis	writer
mantegna	painter
black	chemist
durham	city
monterrey	city
dryden	poet
verne	writer
wallace	writer
magdalena	river
rotterdam	city
isaiah	prophet
robbins	choreographer
ochoa	biochemist
sombrero	island
guangzhou	port
rousseau	philosopher
krishna	avatar
lowell	astronomer
shaw	dramatist
fiji	country
water	actress
becket	martyr
hess	pianist
nash	writer
norma	constellation
chernobyl	city
brindisi	port
oslo	port
wynette	singer
cordoba	explorer
calderon	poet
jerome	saint
astor	viscountess
howard	queen
fleming	bacteriologist
hutton	geologist
hoagland	physiologist
flint	city
lawrence	martyr
morgantown	city
klamath	river
wellington	statesman
roswell	town
clyde	river
woodhull	suffragist
tonga	country
lynchburg	city
guadalcanal	island
mary	jewess
tunis	port
voltaire	writer
goddard	physicist
hawk	physicist
daniel	book
fitzgerald	poet
bunche	diplomat
wright	architect
berkeley	city
dull	diplomat
nablus	city
creation	begin
reed	communist
lennon	songwriter
jacob	biochemist
muller	geneticist
johannesburg	city
dominic	priest
oates	writer
benjamin	patriarch
goliath	warrior
stockton	writer
mitchell	astronomer
currier	lithographer
seychelles	country
ardennes	tableland
hubble	astrophysicist
memphis	city
pickford	actress
tennessee	river
orleans	siege
rogers	psychologist
midland	town
hess	physicist
steinberg	cartoonist
faisalabad	city
dewar	chemist
quine	logician
tallinn	port
cicero	orator
goodall	zoologist
dietrich	actress
acre	district
williams	poet
thessaloniki	city
whitehead	mathematician
eisenhower	general
vicksburg	siege
mary	mother
begin	statesman
woodbury	economist
michelangelo	sculptor
meredith	poet
reno	city
brunei	sultanate
sue	writer
andersen	writer
wesley	clergyman
john	saint
kasai	river
parker	writer
euphrates	river
crawford	sculptor
halley	astronomer
burnett	writer
marlowe	dramatist
guangdong	state
webster	lexicographer
vesey	slave
plano	city
dvorak	composer
purcell	composer
philippine	country
stone	suffragist
allentown	city
klein	couturier
manchester	city
stephenson	businessman
young	actress
rousseau	writer
davis	statesman
luxor	city
tito	statesman
tubman	abolitionist
wright	feminist
mill	economist
macleish	poet
hepburn	actress
turner	historian
horne	mezzo-soprano
augustus	statesman
page	diplomat
silverstein	cartoonist
harvard	philanthropist
isaiah	book
bernard	physiologist
sayers	writer
jam	saint
barnum	showman
jericho	village
nobel	chemist
istanbul	city
full	architect
water	singer
john	artist
gregory	pope
eichmann	nazi
watt	engineer
wood	painter
deere	industrialist
styron	writer
melville	writer
scott	general
sodom	city
eiffel	engineer
epstein	sculptor
columbus	town
shearer	dancer
ham	man
monitor	vessel
wernicke	neurologist
young	egyptologist
entebbe	town
nauru	country
parana	river
greenberg	linguist
jamestown	village
sumner	sociologist
beecher	abolitionist
amazon	river
mondrian	abstractionist
fitzgerald	writer
surrey	county
chevalier	actor
flagstaff	town
parker	saxophonist
granada	city
page	writer
cohn	botanist
ignatius	bishop
hoffmann	chemist
mecca	riyadh
franck	composer
mark	evangelist
fawkes	conspirator
scott	explorer
nanning	city
winchester	city
rand	writer
gabor	physicist
sinai	desert
cretaceous	period
sur	port
petersburg	siege
west	actress
havel	dramatist
luce	publisher
ustinov	dramatist
ledbetter	singer
job	hero
aiken	writer
diesel	engineer
kipling	writer
seneca	statesman
bradstreet	poet
harris	publisher
jeremiah	prophet
scandinavia	peninsula
tacoma	city
mitchell	aviator
weber	physicist
nagasaki	city
gloucester	town
may	ballplayer
kalahari	desert
red	river
fry	dramatist
goodman	clarinetist
norfolk	city
ives	composer
medina	city
tucker	anarchist
nostradamus	astrologer
bede	theologian
mccormick	inventor
mendel	botanist
kazan	city
continent	mainland
burn	poet
stoker	writer
knox	theologian
clay	politician
houston	city
tabriz	city
bartlett	publisher
knox	historian
louisville	city
acheson	statesman
goethe	novelist
lawton	town
spender	poet
crichton	scholar
domino	songwriter
pasadena	city
rousseau	painter
young	saxophonist
krebs	biochemist
kent	county
luke	book
stevenson	writer
antalya	port
mahan	historian
parson	sociologist
orleans	city
turkmenistan	country
wiesel	historian
tolstoy	writer
psalm	book
jackson	singer
lafayette	soldier
io	maid
hank	actor
toledo	city
burroughs	writer
samarkand	city
constantine	city
binghamton	city
mellon	financier
lind	soprano
wiener	mathematician
anthony	suffragist
dryden	dramatist
wilkins	biochemist
simon	psychologist
marshall	statesman
vanderbilt	financier
laffer	economist
sur	city
sunday	evangelist
boulez	composer
parrish	painter
pushkin	poet
tahiti	island
schenectady	city
boot	constellation
ferrara	city
glasgow	city
mcgraw	coach
sousa	composer
stuttgart	city
verona	city
princeton	town
hiroshima	port
halle	city
madonna	singer
porter	writer
oakley	marksman
ricardo	economist
turner	slave
harvey	doctor
herrick	poet
po	river
hess	physiologist
seurat	painter
penn	friend
truth	feminist
newton	mathematician
sterne	writer
fremont	explorer
henry	orator
handy	composer
linz	city
bermuda	island
para	estuary
mitterrand	statesman
ascension	miracle
albion	england
jackson	general
proverb	book
timothy	christian
assault	thoroughbred
geronimo	apache
copland	composer
mach	philosopher
revelation	book
bahrain	island
mitchell	general
klein	mathematician
bernhardt	actress
coward	actor
medellin	city
field	writer
speer	architect
hunan	state
gent	port
hebei	state
page	industrialist
hamburg	port
poitier	actor
bruckner	organist
grant	general
murray	classicist
wallace	insurgent
hopkins	poet
reuben	patriarch
houghton	town
lucas	screenwriter
symonds	writer
wodehouse	writer
vancouver	town
gilman	feminist
monongahela	river
catalonia	district
mitchum	actor
yuma	town
lewis	pianist
wild	writer
mobius	mathematician
snake	river
turner	painter
helsinki	port
venice	city
mcluhan	writer
acapulco	city
gershwin	composer
sidney	poet
young	poet
jonesboro	town
biloxi	town
horta	architect
joachim	composer
haydn	composer
fall	event
houston	politician
seymour	queen
lambert	composer
bradford	printer
bridget	saint
eve	woman
percy	writer
turner	insurgent
bighorn	river
tabasco	state
victoria	port
herbert	musician
ireland	island
aaron	ballplayer
warren	poet
cromwell	general
byrd	explorer
donne	poet
virgo	constellation
edwin	king
bartok	composer
netscape	browser
guadalajara	city
sinclair	writer
amos	prophet
mauldin	cartoonist
benet	poet
abadan	city
beckett	dramatist
conakry	port
meissner	anatomist
duluth	city
lardner	humorist
thompson	physicist
bruno	cleric
spencer	philosopher
chicago	port
peter	saint
atlantic	ocean
bloch	composer
hippo	town
buck	writer
menninger	psychiatrist
stephen	writer
