print	publication
trek	trekker
appear	appearance
cube	block
gong	chime
insistent	repetitiveness
delirious	craze
oppress	suppression
hex	enchantment
actual	realize
jamaican	jamaica
ceremonial	ceremony
diligent	diligence
nurse	nurser
tortuous	complicatedness
noble	nobility
king	kingdom
counter	rejoinder
liberate	liberty
excite	excitement
overwhelm	flood
brush	sweep
slight	rebuff
lunge	drive
circle	lap
aim	determination
heat	hotness
labor	parturiency
messiah	messiahship
throng	multitude
realist	naturalism
jibe	jib
entice	bait
skinny	skin
cold	inhumaneness
alar	ala
dismissive	dismiss
pace	tempo
breezy	breeziness
reincarnate	reincarnation
agitate	excitation
adverse	adversity
discover	find
augment	augmentation
diagram	schematization
deleterious	harmfulness
denote	indication
harmonious	harmony
stunt	acrobatics
drip	dripping
biochemical	biochemistry
help	aid
tough	formidability
emphatic	vehemence
gradual	graduality
wintry	winter
advance	advancement
modulate	modulation
booklet	book
decline	ebb
entail	significance
edgy	edge
observe	notice
proliferate	proliferation
testify	testimony
rank	ranker
accessible	approachability
congruent	congruity
reflective	reflection
harass	aggravation
muck	sludge
imitative	imitate
bad	thrash
immortal	immortality
perpendicular	perpendicularity
associate	relation
trade	switch
affluent	wealth
attendant	attend
pick	choice
negligent	neglect
corrupt	degradation
baptist	baptism
furrow	bevel
clear	lucidity
dramatic	boldness
activate	aerator
worry	troublesomeness
scramble	patchwork
mechanical	mechanic
livestock	stocker
dismember	dismemberment
dart	flit
diagnostic	symptom
stripe	band
draconian	draco
artistic	art
suitable	suitability
commend	citation
foam	effervescence
cheat	deceiver
scar	pit
nest	nester
roomy	room
jain	jainist
scaly	scaliness
dim	vagueness
freeze	pause
extort	extortion
hoax	fraud
uproot	destroyer
rugged	huskiness
murmur	mutterer
endometrial	endometrium
discontinue	stop
bare	nakedness
forge	forger
mortal	mortality
drum	rhythm
conspire	conspirator
thoughtful	contemplation
perceptive	perceive
calibrate	calibration
corrective	correct
impact	impaction
dodder	senility
symptomatic	symptom
squirt	jet
alien	exoticism
sympathetic	like
inflexible	inflexibility
debatable	debate
cross	span
fix	fastness
invalid	invalidity
limit	forte
invent	inventor
deceive	deception
stake	post
pure	vestal
profound	deepness
vindicate	vindication
goad	prod
express	utterance
sequester	sequestration
congestive	clog
sign	subscriber
quantify	measurement
toboggan	tobogganist
astute	shrewdness
uneasy	edginess
guarantee	warrantee
arabian	arab
deceive	delusion
available	handiness
feasible	work
concrete	coalescence
patronize	clientele
certain	assurance
briton	britisher
wash	laundry
march	marcher
steward	stewardship
celtic	gaelic
chatter	prate
slippery	rascality
botch	blunder
sinful	unholiness
bum	cheapness
personal	personality
deadly	venom
traditional	tradition
alternate	alternation
shudder	frisson
rival	competition
line	liner
final	finality
steer	forefront
assume	usurper
invasive	invade
amphibious	amphibia
base	immorality
boxer	box
widen	extent
insecure	insecureness
instantaneous	moment
tap	pat
stool	crap
condense	contraction
undress	strip
digest	concentration
logistic	logistics
ascend	dominance
diet	dietary
suffix	suffixation
transparent	transparency
dissolve	dissolution
militaristic	military
intense	intensity
bad	riskiness
disappoint	dissatisfy
board	lodger
attendant	leave
malian	mali
uncommon	uncommonness
gloss	comment
pithy	kernel
bland	flavorlessness
assign	assignee
preempt	preemptor
dietary	diet
obstruct	stymie
possessive	own
ache	pine
indecent	indecency
crystallize	crystallization
uncomfortable	discomfort
exploit	exploitation
loop	cringle
ravel	disentangler
czech	czechoslovakian
guard	ward
sew	sewer
dream	idealist
indecisive	indecision
crunch	munch
quintessential	quintessence
hesitate	reluctance
crude	coarseness
fertilize	fertilization
exact	exactness
unravel	disentangler
copy	re-creation
withdraw	drawer
sharpen	point
acceptable	take
late	recency
streak	stripe
comfort	solace
cultural	ethnicity
assent	accession
invent	excogitator
promote	improvement
brilliant	glory
member	membership
likely	potential
apprentice	apprenticeship
homely	dowdiness
state	say
obedient	obedience
react	adversary
waste	wastrel
handy	handiness
back	angel
unaffected	unaffectedness
bare	barren
join	joiner
alone	aloneness
qualify	pass
destitute	necessity
lucid	lucidity
believe	believer
bribe	bribery
sacrificial	sacrifice
frequent	frequency
carpet	rug
judge	opinion
settle	dreg
feel	sensation
buoyant	buoy
watch	watchman
white	snow
iranian	irani
lavish	extravagance
charge	mission
certify	security
lacy	lace
gamble	adventurer
scalp	scalper
intercede	arbitration
ache	distress
brittle	brittleness
hustle	streetwalker
alert	alertness
local	vicinity
cancerous	cancer
apologist	apology
minor	minority
note	remark
animal	prurience
tell	recital
connective	connect
gay	celebration
apologize	excuse
bitty	diminutiveness
vault	vaulter
apprehensive	apprehension
ramp	rage
expansive	effusiveness
proselytize	proselyte
protest	demonstrator
alert	alacrity
plane	planation
catchy	catch
study	student
company	party
harsh	abrasiveness
temper	temperance
aerobic	aerobics
chaplain	chaplaincy
roll	peal
critical	crisis
purify	sanctification
signify	sign
operable	practicability
describe	description
odd	oddness
exhale	halitus
glimpse	glance
jab	prod
brief	brevity
rhyme	verse
wire	wireman
emphatic	emphasis
model	sculpture
neglect	pretermission
prompt	abetment
see	position
end	finish
lope	jog
oppressive	persecute
vault	curvet
aim	purpose
wish	regard
puppeteer	puppet
flaky	flakiness
polish	refiner
instantaneous	immediacy
know	awareness
see	sawyer
induce	trigger
storm	surpriser
plug	ballyhoo
prospect	prospector
slant	weight
trade	barter
subordinate	subordinateness
changeable	iridesce
flow	flux
spill	talk
apocalyptic	revelation
inadequate	meagerness
tense	tension
acidic	acidity
elaborate	lucubration
learn	learner
establish	foundation
resourceful	resourcefulness
soft	unfitness
ill	sick
theatrical	dramaturgy
preserve	conserve
colossal	giant
fall	capitulation
run	runner
profit	gainer
minimalist	minimalism
unwieldy	unwieldiness
reconcile	reconciliation
mobilize	mobilization
false	faithlessness
impressive	impressiveness
boomerang	backfire
deduce	inference
annoy	mischief
iridescent	opalescence
straight	straightness
repel	campaign
contrite	sorrow
european	europe
anemic	anemia
notice	citation
squash	crusher
transfer	transferor
film	movie
unclean	impurity
shout	scream
good	improvement
weed	weeder
withdraw	withdrawal
jordanian	jordan
drug	dose
charm	sorcery
big	liberality
nail	nailer
quarrel	controversy
beekeeper	beekeeping
introduce	initiation
inferior	inferiority
heap	batch
immune	immunity
ordain	ordination
executive	run
intrusive	intrude
perverse	contrariness
trip	actuator
settle	liquidation
relegate	classifier
amuse	entertainment
suffocate	choke
teleport	teleportation
radiologist	radioscopy
bar	exclusion
ashen	lividness
automatic	automaton
doctoral	doctor
bid	command
historical	historicalness
smut	pornography
voyage	voyager
bouncy	give
air	broadcast
compound	combination
erudite	eruditeness
flash	twinkle
persuasive	persuade
speculate	theorization
passive	passivity
unlike	dissimilarity
enhance	foil
scuffle	scramble
wind	curler
unsanitary	unhealthfulness
tire	fatigue
efficient	efficiency
flowery	grandiosity
irrepressible	irrepressibility
publish	publication
summit	peak
engineer	technology
distill	distillery
screen	sort
secure	fastness
legislate	legislation
emerge	emergence
portable	portability
rise	ascension
sting	pang
erupt	outbreak
fresh	crust
profitable	profitableness
predictive	bode
disappoint	disappointment
pharmaceutical	pharmacy
vocal	vocalize
frivolous	buffoonery
pronounce	enunciation
corrective	discipline
measure	measurement
look	spectator
groove	groover
singaporean	singapore
ridicule	tease
disengage	withdrawer
calculate	calculator
akin	consanguinity
relax	relaxation
crooner	ballad
comfort	sympathizer
lovely	comeliness
distribute	allocator
grow	increase
plan	undertake
interchange	substitution
human	humanness
bathe	bather
suggest	suggestion
shout	screamer
argentine	argentinian
commute	substitution
doubt	skeptic
beastly	beastliness
unusual	unusualness
vanish	fade
jostle	shove
tribal	tribe
exempt	exemption
greedy	greediness
craven	cravenness
name	namer
mysterious	supernatural
smash	blast
waste	cachexia
refute	rebuttal
conventional	outline
bounce	resilience
devilish	monster
rear	erect
homely	homeliness
rigid	sternness
tactful	tact
refine	nuance
martyr	calvary
scar	scratch
decorator	ornamentalism
pick	picker
blend	concoction
sneeze	sneezer
cling	adhesiveness
islamist	islam
scholastic	school
spirit	animation
pontificate	papacy
pensive	wistfulness
vigorous	energy
crimson	violence
stipulate	condition
twist	wrench
parabolic	parable
bilateral	bilaterality
big	prominence
press	pressure
latent	latency
indicative	argue
eye	eyeball
foul	macule
backward	feeblemindedness
masturbate	masturbation
impossible	impossibility
absorb	absorber
voice	singer
tender	tenderizer
thrill	bang
shout	yell
exude	exudation
pastoral	curate
animate	quickener
unacceptable	unacceptability
touch	junction
disgust	repel
caption	subtitle
testimonial	testimony
bar	prevention
pregnant	pregnancy
racist	anti-semite
deter	deterrence
pacify	mollification
coordinate	coordination
admire	admirer
quaint	quaintness
order	dictate
mint	mintage
contaminate	contamination
reflective	reflectiveness
manifest	materialization
unfaithful	infidelity
dress	decoration
attend	advertence
range	compass
quiescent	dormancy
hound	hunt
consort	companion
course	path
cubic	cubicity
allude	allusion
mercurial	mercury
compulsory	mandate
heroic	hero
slender	fineness
original	originality
spread	spreader
gull	victim
allow	grant
frame	border
attach	attachment
revoke	reverse
originate	start
transit	passage
fruit	fruitage
crook	crookedness
descend	descent
artful	artfulness
repair	restoration
escort	date
articulate	enunciation
orchestral	orchestra
joke	jester
know	knower
reflect	radiance
clear	clarification
manufacture	manufacturer
curse	execration
inconclusive	inconclusiveness
resent	resentment
scribe	calligraphy
cheap	cheapness
dark	darkness
hedge	hedger
broke	agent
exhaust	expulsion
equip	equipment
seasonable	seasonableness
buoyant	chirpiness
metabolize	metabolism
remind	reminder
unreliable	undependability
dissuade	dissuasion
transmit	transferer
abusive	mistreat
vet	veterinarian
invest	investment
take	taker
score	scorer
repeat	iteration
innocent	innocence
shoot	pullulation
alert	liveliness
trip	propulsion
useless	inutility
leach	percolate
assemble	collection
representative	represent
soar	surge
dominate	overlook
argue	indication
interdependent	mutuality
base	baseness
jump	leap
ally	confederate
sniff	sniffer
congenital	innateness
straight	heterosexual
load	adulterator
salty	salt
collect	collection
deflate	deflation
gag	joke
elaborate	expansion
sandbag	sandbagger
disown	repudiation
strike	walkout
mortgage	mortgagor
dirty	dirtiness
browse	graze
state	narrator
die	death
snort	snorter
territorial	district
scratch	scratcher
adult	adultery
strike	expunction
hurdle	hurdler
whine	whimper
nominate	nomination
destroy	destroyer
build	construction
sympathize	empathy
steal	thief
identify	identity
collaborator	partnership
geological	geology
promulgate	proclamation
preparatory	fix
murmur	whiner
biological	biota
venture	stake
proportion	symmetry
use	consumption
mail	sender
denounce	inform
pawn	hock
bookish	studiousness
compulsive	compulsion
marketable	commercialize
premier	premiere
hope	desire
digital	digit
demonstrate	demonstration
air	breeze
study	cogitation
tempt	tempter
love	enjoyment
photocopy	xerox
wait	waiter
mysterious	mystery
defuse	deactivation
rough	blow
conceptual	conceptualization
orb	orbit
exist	subsistence
religious	devoutness
objective	objectivity
actual	genuineness
survive	survival
organize	coordinator
annoy	irritation
cosmetic	deck
drink	drunkard
facilitate	facilitation
manipulative	manipulate
inaugurate	augury
initiate	inductee
overthrow	revolutionist
deposit	bank
subtract	subtraction
incendiary	inflame
lousy	pediculosis
urinary	urine
interrupt	break
foot	pedestrian
transmit	channelization
capricious	impulsiveness
exemplify	exemplar
dictatorial	dictator
anorexic	anorexia
devolve	devolution
envision	picture
hapless	commiseration
steamroller	juggernaut
limit	peculiarity
direct	mastermind
ageless	eon
sing	singer
shock	scandal
irregular	constipation
red	cerise
telecast	telecaster
amphibious	amphibian
fawn	coward
evocative	reminiscence
dependent	dependant
govern	government
guatemalan	guatemala
vacant	vacancy
deal	trade
clarify	clear
buoyant	buoyancy
repair	resort
sign	subscription
duplicate	replica
archetypal	prototype
temperate	self-restraint
surrealist	surrealism
magnify	exaggeration
dominant	dominate
droplet	drop
halt	stop
answer	respondent
zairean	zairese
neglect	negligence
dreadful	awfulness
quick	celerity
rate	place
chatter	palaver
comfortable	comfortableness
pull	force
coach	managership
interpret	interpretation
transport	transporter
deterrent	deter
explode	detonator
illegal	illegality
rich	fullness
cant	bevel
deep	deepness
dictator	dictatorship
machinist	car
pall	curtain
prevail	prevalence
suit	adjustment
blunt	candor
spark	flicker
strum	thrum
changeable	opalescence
ambush	ambusher
strip	stripper
investigate	inquirer
steep	preoccupation
impotent	powerlessness
divorce	divorcee
regent	regency
bid	adjuration
anchor	anchorage
mint	coiner
override	nullification
paleontologist	fossil
smother	suppression
sediment	deposit
assume	fabrication
pause	respite
reserve	reservation
immigrate	immigrant
overpay	overpayment
spot	discernment
adulthood	adult
clear	clarity
load	adulteration
topical	subject
step	footfall
infect	contagion
anesthetic	anesthesia
divide	division
calibrate	graduation
negligible	paltriness
bury	burial
celebrate	fete
philanthropist	altruism
gravitate	gravity
gun	artillery
foreground	limelight
rule	ruler
indignant	umbrage
sheik	sheikdom
hairdresser	vogue
splashy	splash
ride	passenger
code	cipher
want	wish
monetary	money
lance	spear
counteract	counterbalance
validate	establishment
imprison	captivity
use	utility
pay	payment
purebred	thoroughbred
prelude	preliminary
deterrent	deterrence
exacerbate	aggravator
dishonor	shame
life	lifer
deadpan	emotionlessness
analyze	analyst
scent	nose
gay	homosexuality
judge	evaluator
standardize	standardization
patriarchal	patriarch
help	benefactor
recover	rescuer
typify	symbol
continue	continuance
immediate	promptness
swerve	curve
feel	touch
smoky	smoke
dart	darter
grand	impressiveness
aggregate	collector
mismatch	unevenness
transmit	conveyance
insignificant	unimportance
photographer	photography
absurd	absurdity
coy	demureness
ventriloquist	ventriloquism
radiological	radiology
venerable	venerability
inaugurate	kickoff
remember	memorial
brainy	brain
tarnish	macule
limit	circumscription
enumerate	token
oversee	coach
thick	thickness
polemic	polemicist
cognitive	know
ebullient	exuberance
support	assistant
aphrodisiac	sex
twist	construction
exhibit	exhibition
diseased	unwholesomeness
idle	idleness
coalesce	coalescence
dilute	dilution
motivational	motivation
resettle	resettlement
slow	slowness
establish	founder
collide	collision
bore	tediousness
argue	rationality
leafy	leaf
contingent	contingency
restrain	restrainer
minimize	denigration
massive	heft
germinal	source
show	screen
duplicate	repeat
reticent	reserve
curl	lock
disciple	discipleship
escalate	increase
sympathetic	sympathy
respect	esteem
curly	lock
proletarian	labor
crab	irritability
alkaline	alkali
review	inspection
gorge	glutton
advisory	rede
contour	shape
provincial	state
adviser	consultancy
steel	heart
atmospheric	atmosphere
arise	rise
match	pair
smash	knock
officiate	function
react	respondent
periodic	cyclicity
smack	taste
mutate	mutant
forge	hammer
brilliant	glare
glance	peek
quarrel	dispute
consistent	consistency
confer	consultation
baptize	christen
speak	speaker
orator	rhetoric
pardon	pardoner
boast	loudmouth
dense	dullness
blond	paleness
physical	materiality
necessitate	need
clear	perceive
hit	collision
expansive	expand
literary	literature
condense	condensation
prevent	prevention
decisive	finality
discard	fling
lodge	digging
correctional	discipline
respectful	deference
gather	tuck
incorporate	incorporation
purpose	determination
generic	genus
social	society
hedge	evasion
chin	pull-up
enter	participation
talk	speech
discipline	conditioner
raise	ascent
insert	insertion
seize	shanghaier
miss	escape
rotten	putrescence
interfere	intrusiveness
cumbersome	awkwardness
relegate	relegation
go	departure
crusade	crusader
poise	halter
dream	dreamer
advertise	promoter
produce	brand
blend	mixture
orient	arrow
archaeological	archeology
mischievous	mischief
penetrate	penetration
regulate	rule
savage	beast
lose	loser
satisfactory	satisfactoriness
decelerate	slowdown
fib	storyteller
type	character
sign	signal
trace	lineation
hammy	ham
snip	clip
teach	teacher
capitalize	capital
stimulant	provoke
sour	acid
adaptive	adjust
persistent	persevere
specify	limit
lobby	lobbyist
visualize	visualizer
flex	flexion
refine	refinery
impossible	inconceivability
accessory	adjunct
criticize	critic
even	evenness
annoy	pique
comparable	likeness
trust	reliance
assimilate	assimilation
ethereal	ether
resuscitate	resuscitator
common	commonality
dilate	dilatation
editor	editorship
forecast	forecaster
lunge	lurch
utilitarian	utility
leap	jump
invulnerable	invulnerability
appear	apparition
punch	perforation
commissioner	commission
brew	brewer
continue	upholder
unfavorable	unfavorableness
refresh	refreshment
enter	entrant
cosmetic	decorativeness
deck	beauty
decline	wane
speculate	speculator
navigational	navigation
envelop	wrap
theatrical	staginess
resume	resumption
fasten	fastener
persevere	perseveration
smother	suffocate
locate	placement
activate	air
squash	squeezer
telecast	television
needle	goad
shunt	shunter
significant	significance
tumble	acrobatics
mastermind	administration
deplorable	deplore
charge	bill
putter	putterer
honk	toot
rigid	rigidity
potter	putterer
reside	resident
indian	amerind
purpose	resolution
pass	hand
predominate	predominance
mindful	awareness
absorb	acculturation
abusive	scurrility
symbolize	symbolization
correspond	correspondence
minimize	disparagement
austrian	austria
pray	prayer
legalize	legitimacy
draft	drafter
conclusive	finality
espouse	borrow
inconvenient	inconvenience
confuse	illogicality
nutritional	nutrition
ripple	gurgle
ideological	ideology
note	notice
notice	noticer
assiduous	assiduity
reason	decision
grin	smile
sustain	maintenance
acquire	win
ephemeral	ephemera
napoleonic	napoleon
twinkle	scintillation
accord	grant
tick	ticktock
consult	reference
study	meditation
dust	dustcloth
crop	range
insert	cut-in
approve	approver
lukewarm	lukewarmness
duplicate	repeater
stimulate	excitement
specific	specificity
extract	extractor
linguistic	tongue
cranky	irritability
overuse	overexploitation
mobile	mobility
eat	eater
buck	jerk
test	trier
assent	acquiescence
huddle	huddler
dock	stevedore
machine	machinist
fort	garrison
thin	thinness
refine	rectification
occupy	residency
timid	timidity
paraphrase	reword
forbid	ban
precarious	instability
position	placement
fight	fighter
consider	consideration
flood	glut
hew	hewer
pelvic	pelvis
obstinate	stubbornness
distinct	distinctness
hustle	hustler
harmonize	chord
incisive	incision
statesman	statesmanship
detect	observation
track	path
shake	tremble
entail	deduction
provision	sutler
concord	harmony
trickle	drip
knock	critic
strike	hit
try	strain
bum	rotter
sparkle	foam
lean	angle
hush	dimness
thrust	push
roll	vagabond
ask	question
therapeutic	therapy
airy	laputa
rigid	stiffness
separate	separation
take	read
dance	dancer
flip	tosser
defend	supporter
aviator	aviation
disagree	dissent
kidnap	abduction
determine	decision
originate	begin
migratory	migrate
cleave	splitter
perpendicular	orthogonality
putt	putter
debate	debater
grand	enormousness
silver	flatware
soluble	solubility
count	number
pry	crowbar
prejudicial	bias
touch	contact
continue	lengthiness
pirate	plagiarism
tolerant	digest
generate	generation
inaugurate	inauguration
translate	translator
grow	produce
palestinian	palestine
saint	sainthood
ply	run
aware	know
emulate	emulation
lascivious	libido
neurotic	neurosis
kindred	kin
drab	gloom
play	gamble
bungle	awkwardness
sensuous	sense
damage	detriment
pungent	pungency
result	resultant
hot	horniness
neurological	neurology
classify	classification
submit	submission
material	materiality
comply	complaisance
crack	cracker
starve	starvation
sweep	chimneysweeper
appraise	evaluate
exude	seepage
refuel	fuel
metal	alloy
parasitic	leech
transcribe	transcriber
lively	liveliness
comfortable	prosperity
commute	commuter
bloody	bloodiness
layer	level
juggle	jugglery
immerse	dip
colonial	colony
sequence	sequencer
conceptual	gestate
descend	fall
monopolize	monopoly
backward	retardation
authentic	authenticity
leak	escape
clog	curdle
shape	maker
rant	jabber
distinctive	peculiarity
abate	suspension
celebrate	celebrant
edit	redact
serve	waiter
advisable	rede
annoy	aggravation
confer	conference
empty	emptiness
special	peculiarity
motivate	incitement
dung	droppings
resonant	resonance
fly	celerity
rocky	rockiness
molest	molestation
intentional	intention
climactic	climax
bolt	dash
excommunicate	excommunication
fantastic	admirability
fly	aviation
settle	settler
gravelly	gravel
visualize	image
flimsy	pettiness
fresh	freshness
earnest	seriousness
inapplicable	inapplicability
succeed	successor
imperial	emperor
rock	rocker
sift	strainer
refuse	rejection
rapid	speed
grant	grantor
produce	devise
check	assay
distill	extraction
enumerate	item
firm	resoluteness
syndicate	syndication
diversify	diversity
adhere	disciple
trouble	fuss
impress	inculcation
christian	christianity
drive	driver
harmful	harmfulness
stormy	agitation
awkward	self-consciousness
general	generality
diagram	plotter
conduct	conductor
step	footstep
infect	infection
chalky	chalk
refer	referee
depart	takeoff
brainy	brilliance
stir	stirrer
defame	aspersion
anger	ferocity
purify	refine
bathe	bathroom
prevail	victory
write	pen
docile	teach
embryonic	embryo
differentiate	differentiation
pet	darling
cereal	grain
fit	fitness
oppress	suppressor
prod	incitement
assign	allotment
grade	grader
crystalline	transparency
make	creature
reserve	book
considerate	consideration
regulate	regulator
show	presentation
deviate	deviation
bubble	sparkle
prick	sting
head	forefront
suburban	suburb
print	issue
artist	art
dreamy	languor
pivot	swivel
orchestrate	orchestra
cox	coxswain
detect	perceiver
discontent	discontentment
true	truth
pledge	plight
tap	knock
presumptive	presume
washingtonian	washington
speculate	conjecture
hoot	owl
fatten	fatness
enigmatic	prophet
eccentric	eccentricity
rethink	reconsideration
wicked	iniquity
impart	channel
mountaineer	mountain
square	singleness
affirmative	optimism
irregular	irregularity
bounce	animation
permit	license
chatter	yak
brine	seawater
flinch	wince
lift	elevation
low	lowness
argue	read
acrimonious	bitterness
empty	inanity
honor	wage
roll	coil
devious	crookedness
try	trier
unproductive	unproductiveness
dense	awkwardness
feast	banquet
vest	clothe
green	rejuvenation
denounce	deserter
aimless	purposelessness
basal	foundation
rampant	ramp
crisp	snap
emphatic	proclaim
melancholy	melancholic
versatile	versatility
satisfy	satisfaction
lament	keen
star	headliner
squelch	suppression
settle	decision
snap	click
merciful	mercifulness
move	proposer
place	localization
set	mount
fuss	fret
instrument	instrumentation
auxiliary	aide
design	purpose
countless	innumerableness
carcinogenic	carcinogen
moroccan	morocco
sensitive	sensitivity
authorize	authorizer
hoist	elevator
stumble	lurch
hawaiian	hawaii
cathartic	catharsis
shriek	screech
vamp	coquette
corrupt	corruption
exterminate	exterminator
fast	fastness
pacific	peaceableness
abhorrent	obscenity
reactive	react
number	numeral
accommodative	amenability
guide	steer
philanthropist	philanthropy
lurid	ghastliness
clarify	clarity
sedate	tranquilizer
patronize	patron
mathematical	mathematics
slit	slicer
post	poster
rationalize	rationalization
parental	parent
conductive	conduction
hairdresser	style
rob	robber
advisory	consult
georgian	georgia
change	commutation
marketable	peddle
circulate	circulation
invaluable	invaluableness
absent	absence
red	crimson
outlaw	crime
pave	pavage
patriotic	patriotism
maneuver	tactic
pictorial	paint
press	crush
justify	apologist
epidemiologist	epidemiology
charm	tempter
insidious	insidiousness
amuse	fun
revisionist	revisionism
forgive	pardoner
dramatize	play
address	addressee
creamy	cream
digest	abidance
canoe	canoeist
spread	scatter
pretend	pretension
glorify	glory
poor	meagerness
charge	accusation
raid	raider
particular	particularity
devilish	mephistopheles
hasty	hastiness
declare	asserter
novelist	novel
circumstantial	context
calculate	number
dishonorable	dishonorableness
hike	rise
wet	moisture
prejudice	preconception
control	commander
masonic	mason
unlike	differ
legislative	legislate
pit	opposition
pianist	piano
err	slip
afflict	affliction
late	chic
parasitic	parasite
almighty	godhead
infiltrate	infiltration
booklet	leaf
quiescent	quiescence
eliminate	decimation
identify	designation
burst	explosion
work	procedure
caustic	erode
mundane	sophistication
bypass	beltway
cyclic	cyclicity
fatty	fatso
prolific	fertility
candid	openness
mischievous	maleficence
legal	legality
dock	bobtail
become	seemliness
infinite	infiniteness
field	fielder
sleepy	sleep
affect	impingement
loud	volume
bellow	roar
obligate	obligation
urban	urbanize
bloom	blossom
perceptive	perceptiveness
entrance	spellbinder
hilarious	hilarity
overcast	cloud
grate	harshness
despondent	despondency
alert	energy
ancestral	ancestor
gloomy	downheartedness
angry	anger
placid	tranquillity
peasant	peasanthood
stomp	stamper
testify	testifier
promote	supporter
garland	wreath
remember	idea
deliberate	deliberation
deceitful	fraudulence
reproach	castigation
feeble	feebleness
entire	totality
snatch	catch
butt	butter
elaborate	luxuriance
plunder	plunderer
reconstruct	reconstruction
polish	urbanity
belittle	deprecate
skin	skinner
big	boastfulness
oust	ouster
truck	teamster
porous	porosity
panicky	panic
agile	celerity
foul	befoulment
neutralize	elimination
indirect	indirectness
see	check
crusty	abruptness
uncertain	uncertainty
automobile	car
bode	omen
reside	hovel
accessible	access
gambian	gambia
disgust	loathsomeness
stint	stinter
marshal	marshalship
search	quest
dim	dimness
authoritarian	absolutism
twine	twiner
wild	wilderness
cheer	cheerfulness
create	creation
study	discipline
environmentalist	conservation
drill	exercise
fold	cuff
wet	bedwetter
ultimate	ultimacy
work	employment
cut	omission
jurist	jurisprudence
quiz	testee
serve	aid
tag	marker
director	directorship
chemical	chemistry
enlarge	expansion
telex	teletypewriter
disobey	disobedience
black	ghastliness
atheist	atheism
atypical	abnormality
throng	mob
compress	crush
brood	study
deploy	deployment
own	owner
defame	defamation
give	donor
bombard	bomber
manage	handler
outlaw	lawlessness
godly	reverence
ally	confederation
tutor	tutelage
slog	plod
work	worker
close	nearness
compromise	reconcile
imitate	copycat
conciliatory	pacify
scribble	scribe
top	topper
navigate	pilot
lead	leader
native	nativeness
decorate	grace
discordant	disagree
asthmatic	wheeze
explode	detonation
penitentiary	repentance
distinguish	deviation
induce	induction
fleece	wool
prussian	prussia
grasp	clasp
dubious	doubt
mastermind	organizer
walk	walker
stumble	slip
audacious	courage
break	ruggedness
prosecute	prosecutor
metastatic	metastasis
propellant	propel
table	tabulation
upset	upsetter
propel	propulsion
visit	sojourn
detox	detoxification
cubic	three-dimensionality
bag	bagger
adventurous	adventure
whip	lash
fathom	sound
bright	luminosity
surgical	operation
busy	busyness
quiet	tranquillity
pit	playoff
ankle	anklet
legitimate	logicality
hush	silencer
argue	reason
relative	compare
variable	variability
execute	murder
safe	safeness
yield	surrenderer
object	expostulation
gigantic	giant
renege	revoke
compose	composure
peculiar	peculiarity
travel	movement
reedy	reed
indonesian	indonesia
carry	carrier
metric	meter
crook	bend
translate	translation
tap	tapster
remember	remembrance
dispose	inclination
cool	coolant
poison	poisoner
irrelevant	irrelevance
repress	repression
disadvantageous	disadvantage
falsify	disproof
skim	skimmer
audacious	speculation
dependable	security
dot	point
excite	energize
applaud	clapper
attractive	attractiveness
russian	russia
haunt	ghost
overstate	exaggeration
hearty	substantiality
pediatric	pediatrics
chatter	twaddler
wallow	triumph
indicate	indication
move	motion
expel	ejection
pinpoint	speck
dismay	alarm
impure	impurity
fudge	fake
contradictory	contradict
masculine	masculinity
academician	academy
document	documentary
hypnotist	hypnotism
broad	tolerate
commander	commandership
decorate	ornamentation
reverberate	repercussion
historic	history
meet	assembly
shed	molter
motile	motility
free	release
medium	spiritualism
shoot	gunman
blast	damn
deny	denier
respect	deference
bottle	bottler
sarcastic	sarcasm
horticulturist	garden
insoluble	insolubility
peep	chirp
charm	influence
secure	security
distasteful	disgustingness
strain	strive
adhesive	adhesiveness
liberate	liberation
affluent	flower
accurate	preciseness
gripe	whiner
dense	density
beggar	pauper
shingle	shingler
put	placement
visualize	picture
game	heart
mail	sendee
code	cryptography
interlock	mesh
brawl	quarrel
count	counter
indifferent	indifference
loom	column
incapable	incapability
ogle	ogler
fraternal	fraternity
live	life
equalize	equalization
repetitive	repetitiveness
receive	recipient
argue	argument
port	portage
imagine	ideation
make	make-believe
dig	excavation
relevant	relevance
repulsive	repel
charge	charger
organic	organism
tear	rupture
repellent	resist
assail	attack
expatriate	deportation
geneticist	genetics
retinal	retinene
torment	tormentor
slovenian	slovenia
purify	purification
thirsty	thirst
conflict	dispute
far	farness
choppy	choppiness
project	suggestion
livable	populate
break	wear
geologist	geology
oily	greasiness
implicit	implicitness
plan	planner
predict	prediction
entice	temptation
linear	total
inflame	inflammation
transit	theodolite
spongy	sponginess
respond	respondent
dainty	squeamishness
arty	art
bless	blessedness
collaborate	collaborator
still	hush
akin	kin
worry	concern
balmy	craziness
dart	iceboat
number	enumeration
connect	join
cosmopolitan	universe
erode	erosion
hire	boss
meek	meekness
tonal	timbre
generate	genesis
freight	cargo
timely	time
appeal	invocation
ascendant	ascend
invest	investor
hideous	hideousness
disapprove	disapproval
coat	application
accelerate	speed
modernize	modernization
departmental	department
round	circle
adhere	attachment
smooth	smoothness
grow	farmer
care	lovingness
flashy	flamboyance
consummate	master
declassify	declassification
hoard	cache
fleshy	flesh
interrogate	question
support	accompaniment
equalize	equalizer
rat	deserter
triumphant	prevail
appreciative	gratefulness
hapless	pity
incarnate	embodiment
reformer	reformism
motivate	propulsion
toxic	toxin
begin	start
irritate	discomfort
amputate	amputation
flat	flattery
declarative	announce
healthy	health
exuberant	luxuriance
flip	turnover
rout	dent
intangible	intangibility
howl	lament
vacate	resignation
english	anglicise
twist	distortion
trumpet	trumpeter
pardon	amnesty
devious	deviousness
rabbinical	rabbi
wearable	wear
outfielder	outfield
ruin	dilapidation
disappear	vanisher
bend	bender
decline	descent
chaotic	chaos
vomit	emetic
adopt	follow
irresistible	irresistibility
stuff	blockage
woo	court
conduct	transaction
compare	comparison
find	finder
nasty	cattiness
rush	speed
enter	participant
iconic	icon
model	simulation
produce	creation
criminal	crime
amenable	amenability
rape	outrage
ordain	enactment
stimulate	energize
apt	aptness
careful	parsimony
atrocious	monstrosity
legitimate	legalization
reverent	reverence
expatriate	exile
irresponsible	irresponsibility
blackmail	blackmailer
obstruct	hindrance
delinquent	delinquency
grumble	rumble
talk	speaker
desegregate	integration
indecent	indecorum
deft	adeptness
cellular	cell
deadly	deadliness
harm	damage
embody	shape
explode	plosion
shatter	smash
laud	glorification
prophetic	prophet
unpleasant	unpleasantness
ejaculate	ejaculator
action	lawsuit
apologize	apology
inflict	imposition
seaworthy	seaworthiness
inauspicious	inauspiciousness
nip	clipper
neglect	disregard
whack	walloper
reach	arrival
devolve	deterioration
catalan	catalonia
deluxe	impressiveness
beat	beater
worry	care
absolutist	dictatorship
run	flow
sift	sieve
eliminate	annihilation
minister	curate
commune	communion
hypocritical	hypocrisy
deliver	deliverer
have	feature
flamboyant	flamboyance
generational	coeval
love	affectionateness
remove	remover
discharge	release
cogent	weight
pave	sidewalk
tempt	allure
boric	boron
postal	mail
diarist	diary
show	demonstrator
stock	stockpile
eurasian	eurasia
modify	modifier
slick	slickness
teacher	teachership
unlawful	wrong
sorcerer	sorcery
love	lover
abusive	abuse
veterinary	veterinarian
preparatory	organize
scan	scanner
livid	lividity
troll	angler
few	fewness
deduce	deduction
revoke	abrogation
game	mettlesomeness
scholarship	scholar
abduct	abductor
electrostatic	electrostatics
adequate	adequacy
jumble	confusion
obtuse	obtuseness
steady	steadiness
norwegian	norway
seal	sealant
childlike	child
cater	caterer
courteous	graciousness
flimsy	flimsiness
transplant	transferer
invest	coronation
pose	impersonation
wipe	wiper
quantify	quantification
porous	pore
choose	predilection
evocative	recall
vascular	vascularize
salute	salutation
tanzanian	tanzania
appalachian	appalachia
consolidate	consolidation
vivid	color
radial	radius
depress	dejection
default	nonpayment
gastric	stomach
consume	squander
joyful	joy
clog	obstruct
probe	examination
didactic	education
lacy	web
encapsulate	encapsulation
capture	enchantment
traditional	custom
instill	instillation
depreciate	depreciation
cover	coverage
impress	impression
breed	breeder
howl	wailer
radiate	radiance
gay	homosexual
replace	substitution
hideous	repel
president	presidency
cathedral	cathedra
vary	variability
arch	bow
tell	evidence
recover	recovery
obstruct	obstruction
bare	sparseness
determine	determination
dab	tap
stormy	storm
collaborator	collaboration
chase	pursuer
vital	indispensability
slog	pad
diplomatic	diplomacy
neutralize	murderer
skin	pare
issue	exit
common	mutuality
complacent	complacency
laugh	joke
inexact	inexactness
convalescent	convalescence
portray	portraitist
trustworthy	confidence
invalidate	annulment
impart	carry
revoke	reversal
frontal	front
essential	necessity
insoluble	unsolvability
serve	server
close	shut
go	pass
depart	departure
musicologist	musicology
puritanical	puritanism
color	semblance
pure	virginity
dominate	mastery
swear	testifier
ordain	ordainer
lament	elegy
approve	approbation
relieve	palliation
amiable	good-temperedness
coincident	concurrence
trample	trampler
implant	plant
narrow	narrowness
accelerate	acceleration
outlaw	criminal
regenerate	re-formation
hoof	hoofer
nag	scold
pretty	prettiness
mellow	fullness
licentious	profligacy
charitable	charitableness
check	arrest
trade	sell
relocate	resettlement
indulgent	softness
suppose	guess
pictorial	picture
serve	dish
rebel	maverick
lean	pitch
unambiguous	unambiguity
naive	naivete
submissive	submissiveness
unify	merge
open	hatchway
shanghai	impress
deck	adornment
archaic	crudeness
unionize	organizer
tease	tantalus
cagey	wariness
criminal	criminalism
define	shape
act	play
insistent	imperativeness
capricious	notion
dress	attire
gap	open
disclose	exposure
explicit	explicitness
bombastic	pretentiousness
anesthesiologist	anesthesiology
intersect	intersection
associate	association
cheat	swindler
knock	knocker
watch	seer
transmit	sender
materialistic	materialism
design	architect
click	tick
submit	deference
explode	explosion
retain	lengthiness
release	relinquishment
deal	dealer
propagate	generation
lubricate	lubricant
late	lateness
apt	brightness
jump	bounder
research	inquiry
pronounce	articulation
race	racer
brackish	brine
emotional	emotionality
project	projection
fade	atrophy
act	roleplay
absorbent	absorbency
dead	apathy
circulate	propagation
license	licensee
hate	abhorrence
camouflage	disguise
beat	conqueror
dismay	alarmist
candid	heart-to-heart
filthy	dirt
cure	harden
revolt	revolution
speculate	guess
ape	apery
oppressive	absolutism
convenient	appliance
slump	depression
disperse	scatter
exemplify	typification
climb	climber
renovate	renovation
culminate	apogee
clear	clearness
dust	debris
different	differ
pave	pavement
errant	errancy
powder	fineness
steam	haziness
bear	carrier
emotionless	unemotionality
stipulate	stipulation
deck	beautification
cry	weeper
profound	profoundness
rub	abrasion
commemorate	commemoration
refractive	refract
big	gravidity
plaster	plasterer
beat	rhythm
annoy	plague
bend	flexion
warm	heater
brassy	shoddiness
develop	evolution
peck	beak
prohibition	dry
skate	skater
determine	regulation
childless	childlessness
conduct	hand
repel	repellent
divest	divestiture
extreme	utmost
intercept	catch
politics	politician
tease	pest
pat	opportuneness
barb	spine
vibrate	shake
settler	colony
perfume	perfumery
outspoken	frankness
check	chink
present	presentness
light	illuminance
septic	sepsis
current	currentness
rat	rotter
revive	revival
lecture	lectureship
gynecological	gynecology
wiretap	bug
crush	crusher
fleet	fleetness
rope	leash
inquisitive	investigate
change	version
evert	inversion
grudge	niggard
fix	set
sociable	sociability
diffuse	dispersion
misty	haziness
choke	garroter
string	chain
constitutionalist	constitutionalism
infuriate	infuriation
mature	growth
ethical	ethic
swerve	course
diabetic	diabetes
insubstantial	insubstantiality
pound	impoundment
broad	liberality
surgical	surgery
wonder	wonderer
invite	invitation
use	user
opponent	adversary
disburse	spender
skid	skidder
confess	confession
fence	fencer
urge	pressure
ski	skier
smile	smiler
relapse	recidivism
entrust	trust
ill	inauspiciousness
faithless	treason
crisp	chip
respiratory	breathe
argue	reasoner
enthusiastic	enthusiasm
fantastic	magnificence
substitute	deputy
passionate	passion
bantam	petite
communicative	communicate
lonely	forlornness
false	falsity
extraneous	immateriality
parcel	parcellation
atrocious	frightfulness
partner	partnership
coarse	harshness
necessitate	necessity
sharp	asperity
dream	reverie
conscious	consciousness
muscular	muscle
look	spirit
spiral	helix
disappear	vanish
tutorial	coach
massacre	slaughter
futuristic	futurism
light	agility
testify	witness
average	averageness
supply	provision
supportive	support
pleasant	please
project	hurl
feel	barbel
flee	escape
expeditious	dispatch
rest	rester
sear	scorch
restrictive	restrict
moderate	reasonableness
discover	inventor
resist	defender
audit	auditor
consist	consistency
exhaust	exhaustion
consensual	consensus
agree	harmony
sprint	dash
strain	tension
consume	waste
suffice	enough
bore	drill
hygienic	hygiene
godly	fear
buddhist	buddhism
offensive	offensiveness
rout	gouge
skin	abrasion
apologize	apologist
synonymous	synonymy
electrify	electrification
satisfactory	satisfy
calculate	figure
resonant	plangency
forbid	interdict
newsworthy	newsworthiness
inhale	inhalation
cut	cutter
decorate	decorator
precede	foreword
adoptive	adopt
organize	constitution
atrocious	atrocity
abrogate	abrogation
reason	wisdom
enumerate	list
score	mark
mastermind	originator
torrential	flood
cross	sweep
please	joy
persuasive	persuasiveness
compose	component
momentous	momentousness
converge	convergence
float	drift
fleece	shearer
provide	caterer
islamist	islamism
bottomless	bottomlessness
mortal	person
sour	sourness
potter	ceramic
blasphemous	profanation
defender	guardianship
stonewall	stonewaller
encroach	trespass
inquisitive	curiousness
tall	tallness
preserve	preserver
innocent	artlessness
careful	carefulness
kind	digest
connect	link
previous	prematureness
judicious	wisdom
feisty	heart
capitalize	capitalization
bulwark	rampart
lease	charter
fickle	faithlessness
defender	protectorship
blast	barrage
play	playlet
bag	sack
inflame	heat
economic	economy
charitable	kindliness
perceive	comprehension
tar	pitch
ferocious	ferociousness
stock	stockist
tap	tapper
crimp	kink
awaken	waker
relax	relaxer
stress	dialect
central	centrality
tubular	cannula
antagonistic	antagonism
restrict	limitation
unwise	folly
involve	participation
dizzy	dizziness
animate	revival
circulate	dissemination
curious	curio
shakespearian	shakespeare
liberian	liberia
racial	race
spend	spender
chronicle	chronicler
yugoslavian	yugoslav
crusade	energy
open	opener
break	breakage
joint	jointer
straight	heterosexuality
symbiotic	symbiosis
spice	spiciness
wonder	curiosity
graceful	gracefulness
practice	use
entangle	tangle
attract	appeal
gutsy	gutsiness
confidential	confidence
flaunt	exhibitionist
rig	rigger
water	irrigation
hint	suggestion
adjust	conformist
tenant	occupancy
brainstorm	insight
green	greenness
constrict	constriction
chop	chopper
arduous	arduousness
metatarsal	metatarsus
audacious	boldness
chubby	chubbiness
back	supporter
breeze	cinch
patron	sponsorship
lease	renter
shout	bellow
honk	honker
perfume	aroma
cardinal	cardinalship
assert	asserter
arthritis	arthritic
light	lightness
rest	breathe
sensual	sensuality
outback	farness
spell	mean
speculate	speculation
enterprising	enterprise
penetrate	perforation
perch	roost
edgy	edginess
crystallize	crystal
socialist	socialism
revise	rewrite
install	facility
opportunist	opportunism
fool	chump
imprison	jail
stagnant	stagnation
waste	prodigal
discredit	disrepute
churn	turbulence
jab	dig
asexual	asexuality
slippery	slickness
cozy	coziness
stand	stance
thin	sparseness
behave	behavior
machine	machinery
dress	stableman
empirical	empiricism
watch	observation
expect	waiter
creamy	creaminess
grave	weight
flashy	garishness
wrestle	wrestler
paw	hand
go	departer
joyous	joy
bright	brightness
differentiate	difference
dependable	loyalty
review	recapitulation
periodic	period
transfer	transferer
foolhardy	head
corrupt	violator
godly	idolize
demolish	demolition
distribute	allotment
sweat	perspiration
conflict	misdemeanor
oppressive	burdensomeness
vanish	vanisher
disgust	offensiveness
custodial	hand
yodel	descant
apprehensive	apprehend
divest	disinvestment
swell	intumescence
dangle	swing
stifle	stifler
humble	humility
humiliate	chagrin
neutralize	neutralization
truant	truancy
assertive	assert
retire	retirement
expose	exposure
leak	leaker
uninfected	cleanness
deceitful	fraud
salesman	salesmanship
calm	hush
clement	clemency
pollster	poll
commercialize	market
imperial	empire
luminescent	luminesce
electrify	wire
transcendent	exceed
californian	california
audible	audibility
spare	sparseness
feeble	lameness
conform	conformity
subjugate	conquest
cosmetic	ornamental
plant	set
marvel	wonder
disembark	debarkation
segregate	segregation
active	activity
human	homo
psychopathic	psychiatry
confront	confrontation
jerk	flick
managerial	director
sticky	stickiness
static	constancy
individual	individuality
exit	farewell
wobble	wobbler
bouncy	resile
divergent	diverge
win	winning
good	melioration
bore	woodborer
tide	billow
script	booklet
segment	section
optometrist	eye
concoct	confection
monumental	monument
prophetic	prophecy
autoimmune	autoimmunity
prosecute	pursuance
northeasterly	northeast
televangelist	televangelism
gravitate	gravitation
paternal	paternity
elapse	lapse
impassive	emotionlessness
originate	newcomer
hot	hotness
phonetic	phone
mourn	mourner
male	maleness
tag	label
bouncy	liveliness
bail	bailor
responsive	antiphonary
chuck	tap
discernible	note
dermal	dermis
boisterous	ferocity
sketchy	sketch
blasphemous	blasphemy
sensible	feel
repel	rebuff
rape	raper
diplomatic	delicacy
right	rightness
meld	canasta
interconnect	interconnection
miserable	misery
allergic	allergy
regard	gaze
maximize	maximum
relegate	class
flip	pass
domestic	domesticity
modify	changer
develop	development
watch	spectator
haul	drag
statistician	statistic
deflect	diversion
masturbate	tosser
puffy	intumescence
tropical	tropic
disperse	dispersion
divine	godliness
handicap	hindrance
fissure	crevice
defend	representation
slip	slump
cultural	acculturation
flow	flowage
receive	receiver
secrete	secretion
note	mentioner
print	printer
milky	milk
disconnect	disjunction
emanate	emission
get	apprehension
cloister	reclusiveness
expansive	inflate
abound	burst
creative	creativity
intolerant	intolerance
shadowy	apparition
despicable	unworthiness
assess	assessment
electromagnetic	electromagnetism
strip	undress
cleave	rent
handle	palm
vent	venter
mythic	myth
capricious	abnormality
pollute	pollutant
enlist	recruit
obscure	humbleness
remedial	redress
initiate	pioneer
accommodate	accommodation
hoax	prankster
episcopal	bishop
hoard	hoarder
err	mistake
web	net
philosophic	philosophy
harp	harmonica
angelic	seraph
compel	compulsion
air	transmission
readjust	readjustment
lurk	lurker
strenuous	arduousness
inopportune	inopportuneness
submersible	submerge
enact	portrayal
meek	apathy
heavy	heaviness
intimidate	bully
close	closeness
flexible	flexibility
curious	singularity
mince	moderation
abdicate	renunciation
lumpy	ball
rightful	right
disprove	rebutter
analogous	equate
sour	zymosis
circular	lap
accede	accession
lifeless	inanimateness
snuff	sniff
report	description
bestow	bestowal
probable	probability
efficacious	efficacy
membership	member
cram	crammer
float	floater
tube	pipe
reversible	revoke
sprinkle	spatter
darwinian	darwin
croak	croaker
weave	ramble
classify	sort
warn	admonition
voluminous	fullness
dart	dash
collar	apprehender
gulp	gulper
excessive	exceed
lend	loan
berth	moor
firm	stiffness
induce	inducement
degrade	degradation
certify	authentication
crafty	craft
asthmatic	asthma
indian	india
neutralize	nullification
trustworthy	trust
pleasant	pleasantness
pathological	pathology
spurt	flush
deal	transaction
centralize	centralization
gastronomic	gastronomy
endocrinologist	endocrinology
yawn	yawner
inflate	inflation
bounce	bouncer
confirm	documentation
evil	ferociousness
whittle	whittler
inhospitable	inhospitableness
candid	candor
trot	jog
find	discovery
meteorologist	meteorology
mental	mentality
statistical	statistic
attract	attraction
chase	tail
differ	difference
fire	discharge
polyglot	linguist
pacifist	pacifism
whisper	whisperer
sever	rupture
catholic	catholicism
sample	taste
tamper	imp
banish	relegation
inspire	ecstasy
defame	blot
stable	stability
deck	knockdown
catholic	universality
jerk	tug
rid	disembarrassment
carefree	carefreeness
confederate	confederation
median	medium
biological	biology
helpless	helplessness
mean	miser
italian	italy
mexican	mexico
cosmetic	enhance
adolescent	childhood
zest	spice
wharf	pier
positive	positivity
formulate	rule
point	arrow
consort	association
predominate	reign
enlist	draftee
appoint	appointee
amuse	laugh
design	invention
establish	constitution
excavate	excavation
infallible	infallibility
actual	actualize
furrow	groove
curl	kink
ardent	ardor
wind	winder
magnify	enlargement
discipline	bridle
ask	expectation
incumbent	incumbency
perceive	perceiver
rear	parentage
needy	neediness
reconcile	conciliation
falsify	falsification
collateral	validate
satanic	satan
crop	browse
cannibalistic	cannibal
designate	denomination
jive	swing
sack	plunderage
ride	drive
tinker	tinkerer
visit	visitor
advantageous	advantage
comb	unsnarl
seize	capture
rent	renter
contend	conflict
alter	alteration
assemble	hookup
wipe	rub
translate	interpreter
exchange	interchange
choral	refrain
enforce	enforcement
falsify	distortion
spot	smudge
titular	title
cock	hammer
restless	restlessness
simplify	reduction
deluxe	lavishness
armenian	armenia
measure	meter
rag	ragtime
absorb	occupation
possessive	possessiveness
sooty	smuttiness
offensive	hurt
ill	illness
good	humanitarian
slap	smack
kill	killer
dormant	listlessness
fortify	fortress
engage	operation
citizenship	citizen
reform	reformation
tidal	tide
capture	charmer
act	action
fertilize	fertilizer
uphold	upholder
deconstruct	deconstruction
allergic	hypersensitivity
uruguayan	uruguay
deny	denial
deductive	deduce
start	begin
write	writer
reinterpret	reinterpretation
chatty	talk
moldy	mustiness
limp	hobbler
yield	wage
pledge	subscription
humanitarian	humanity
appropriate	appropriator
denote	reference
melt	thaw
affluent	affluence
promote	aggrandizement
arm	weapon
adjective	procedure
induce	cause
froth	spume
clear	top
pounce	swoop
unsatisfactory	unsatisfactoriness
black	smuttiness
western	occidentalize
fijian	fiji
fasten	fastness
tend	attendant
potty	drunkenness
new	newness
georgian	george
participate	participation
naval	navy
lithuanian	lithuania
rice	ricer
store	stocker
bake	baker
condemn	condemnation
favor	favorite
stalk	prowler
humanist	humanism
rule	rein
fight	struggle
redemptive	deliver
documentary	document
overwork	exploitation
subordinate	subordination
inhabit	inhabitancy
precede	predecessor
fog	indistinctness
switch	shift
inactive	motionlessness
angle	angler
dunk	dip
bounce	pep
southern	southernness
ventricular	ventricle
bureaucratic	bureaucracy
quicken	animation
busy	fussiness
contradict	contradiction
pacify	peace
process	processor
magnify	magnification
persuasive	carry
spherical	sphere
close	completion
dirty	loathsomeness
adept	ace
percussive	percuss
waste	wastage
comb	comb-out
bind	affiliation
tacky	cohesiveness
stone	rock
sacred	sacredness
politic	blandness
predict	prophecy
technician	proficiency
break	development
lead	best
prepay	prepayment
ascend	ascent
vanish	disappearance
curse	hex
motorbike	cycle
hiss	hisser
regressive	regress
screen	screener
casual	carefreeness
modest	reasonableness
stalinist	dictatorship
modal	mood
dissimilar	dissimilarity
grind	grounder
affectionate	affectionateness
symmetrical	symmetry
senatorial	senator
accurate	exactness
hold	carriage
coincident	simultaneity
attend	attention
lounge	recliner
unholy	unholiness
popularize	popularization
surfboard	surfer
effective	effectiveness
flash	blinker
suffer	sufferance
adventurous	adventurousness
issue	supply
disband	disbandment
anticipatory	predict
itinerant	itinerate
chaste	virtue
align	alliance
stable	constancy
silent	silence
load	stevedore
voice	articulation
check	containment
merciless	mercilessness
prolong	extension
match	matchmaker
rehabilitate	rehabilitation
sound	audio
adorable	adore
activate	activation
synchronize	synchronism
admit	admission
disparage	disparagement
swing	sweep
promenade	amble
fair	fairness
geometric	geometry
transgress	misdemeanor
anticipate	anticipator
pursue	follower
democratic	democracy
nosy	nose
haul	puller
raise	conjure
string	thread
columbian	columbus
hit	hitter
speak	talk
charge	burden
guarantee	guarantor
gracious	benignity
fail	failure
honk	beep
dampen	weakener
inconsolable	despondency
shoot	sprout
bag	packer
motivate	motivation
share	parcel
woolen	wool
physicist	physic
retard	retardant
preempt	preemption
purple	violet
blunt	bluntness
mastermind	organization
bland	flatness
testimonial	recommendation
clue	clew
ravel	tangle
grind	mash
promise	promiser
repair	mender
state	affirmation
theorist	theory
propel	impeller
scour	abrader
mile	miler
dependent	depend
abnormal	abnormality
bitter	resentment
eerie	eeriness
reproduce	reproduction
disqualify	disqualification
ritualistic	ritualism
satirical	sarcasm
apocalyptic	apocalypse
conclusive	reason
harmonious	commensurateness
sign	ratification
familiar	familiarity
easy	wanton
purify	purge
box	packer
necessary	necessity
shape	form
stack	stacker
conditional	conditionality
dunk	dipper
adjust	adjuster
brilliant	magnificence
connect	articulation
resolve	resolution
fee	feast
hold	support
reap	harvest
stimulate	stimulant
subjugate	national
apparent	appear
frontal	battlefront
restrict	shackle
chuckle	chortle
analytic	analysis
herd	crowd
cold	coldness
conventional	conventionality
puffy	tumidity
abdominal	abdomen
sure	sureness
quicken	quickener
reactionary	reaction
immobile	immobilize
lone	hermit
big	munificence
pink	ping
fatty	adiposity
consonant	harmony
academic	academician
stray	drift
probate	probation
correlate	correlation
androgynous	hermaphrodite
decay	putrescence
revoke	countermand
molar	molarity
drawl	drawler
thwart	frustration
honest	honorableness
cheer	cheerer
coin	neologism
fudge	falsification
topical	topic
terrace	patio
stumble	stumbler
rat	scab
effective	effect
oblige	obliger
coincident	coincidence
deck	decoration
frame	framer
voluminous	bulk
contribute	give
calculate	calculation
produce	producer
predate	antecedent
post	carry
mod	modernity
poach	poacher
sparkle	glitter
post	mark
recruit	recruiter
rank	superiority
repudiate	repudiation
identify	recognition
bare	fruitlessness
evangelist	revivalism
careful	slowness
frame	redaction
brawl	brawler
harsh	cruelty
seminarian	seminary
demonstrative	illustrate
emigrate	emigration
tread	trample
penitent	repent
disruptive	tumult
voyage	cruise
disagree	discord
happen	materialization
proximal	proximity
mellow	mellowness
rivet	riveter
allowable	permit
pass	bye
purge	catharsis
addictive	addict
immanent	subjectivity
accompany	escort
normalize	normalizer
nice	niceness
free	looseness
shapely	form
smack	thwack
pace	footstep
monogamous	monogamy
uncompromising	inflexibility
retaliate	retaliation
entrance	entrancement
continent	hold
match	agreement
unbalance	derangement
shave	graze
discern	delicacy
slow	slowdown
blasphemous	profaneness
crump	thump
shave	trim
judicial	judge
decide	decision
postulate	postulation
aggregate	sum
olympian	olympia
uproot	eradication
sidetrack	straggle
migrant	migrate
grave	graveness
limp	flabbiness
prior	priorship
depart	pass
intelligent	intelligence
evaporate	vapor
classify	class
proclaim	ecphonesis
scratch	engraver
waste	bonyness
turn	emergence
trade	trade-in
rub	chafe
memorize	memorization
reveal	revelation
traditionalist	traditionalism
motivate	act
orient	pointer
control	moderation
falsify	falsifier
invent	conceptualization
intellectual	cognition
equal	peer
roman	papist
bombastic	bombast
despondent	despond
careful	caution
redevelop	renovation
spatial	space
sulphuric	sulfur
defend	defender
quantifiable	quantifiability
crouch	stoop
procedural	procedure
brave	courage
inadequate	inadequacy
fly	flier
unresponsive	unresponsiveness
scurry	scamper
notice	sign
lifelike	naturalness
attend	attendant
demolish	pulverization
consume	consumption
critical	finality
rap	knock
consecutive	sequence
communist	communism
farcical	ridicule
copious	fullness
causative	cause
chauvinistic	chauvinist
decorate	decoration
insistent	insistence
personable	personableness
prevent	obviation
sun	sunlight
taiwanese	taiwan
guard	warder
plunge	submersion
paragraph	paragrapher
lead	eminence
direct	directivity
profound	profundity
molecular	molecule
drape	drapery
criminologist	criminology
invite	guest
apply	application
swing	rock
hypodermic	hypodermis
fight	combatant
shock	shocker
catalytic	catalysis
cartoonist	cartoon
lead	acme
murder	dispatch
put	set
fly	pilot
caroline	charles
forfeit	release
erase	destruction
constant	constancy
convertible	convertibility
celebrate	fame
sight	eyesight
impregnate	infusion
masculine	maleness
squawk	roarer
deviate	variation
discriminate	discrimination
vibrant	resonate
hasty	precipitate
roar	bellow
theorize	theorization
draw	lottery
butch	slaughter
lascivious	lecherousness
represent	representation
stray	straggler
smash	smasher
ape	copycat
indulgent	lenience
illegitimate	criminal
wallpaper	wallpaperer
halt	arrest
record	registrar
harbor	harborage
puddle	pool
motley	calico
seismologist	seismology
supplant	substitute
jeffersonian	jefferson
electronic	electronics
alarmist	alarmism
rickety	tremble
cheat	heist
impregnate	fertilization
bizarre	eccentricity
occupy	occupation
coin	coiner
bungle	blunder
deluge	flood
cleanly	cleanliness
levitate	levitation
elude	evasion
disparate	disparateness
justify	justification
innovative	innovativeness
yank	yanker
machiavellian	machiavelli
august	dignity
revolutionize	galvanizer
commandeer	highjacker
civil	politeness
announce	harbinger
intimate	inkling
glossy	polish
corrupt	pervert
bailiff	bailiffship
identifiable	identify
similar	similarity
dictate	dictator
reject	sneerer
downy	fluff
allowable	allow
assail	attacker
claim	arrogator
destitute	privation
race	runner
swing	lilt
fiddle	trivialize
weak	fail
register	registration
curse	swearer
long	longness
rent	charter
starve	hunger
trace	tracer
manly	man
residential	residency
outward	outwardness
purify	purity
picture	depiction
implant	implantation
crusade	champion
darken	blacken
hold	capacity
absorb	absorption
moralistic	moralism
stenographer	shorthand
slack	shirk
render	output
evocative	reminisce
cripple	lameness
haunt	obsession
moral	morality
popular	popularity
gaze	starer
spread	distribution
foul	polluter
weighty	heaviness
supplant	surrogate
squawk	whiner
lodge	hostel
state	statement
coptic	copt
exceed	transcendence
doubt	agnostic
false	falsehood
dock	pier
proclaim	proclamation
banter	facetiousness
composite	complex
sliver	pare
fabricate	storyteller
spot	blob
deceitful	craftiness
past	pastness
unintelligent	stupidity
confirm	affirmation
kneel	kneeler
pluralist	pluralism
shuck	chaff
calm	composure
syndicate	consortium
conceive	conception
banish	banishment
organize	administration
forgive	forgivingness
wind	bend
immature	immaturity
whiff	puff
estimate	guess
ooze	seepage
mouth	sass
liberate	autonomy
effeminate	effeminacy
bad	badness
ask	inquirer
recuperate	convalescence
sample	taster
stale	staleness
ulnar	ulna
sweeten	enhancement
nudge	prod
bungle	incompetence
agree	agreement
regenerate	regeneration
reformer	meliorism
captive	enslavement
unselfish	generosity
slump	sloucher
order	prescription
coherent	cohere
wash	rinse
subscribe	return
trace	line
deflate	deflator
bowery	arbor
make	pee
refer	applicability
evaporate	vaporization
please	pleaser
sharp	sharpness
endocrine	hormone
fee	feeder
highlight	highlighter
retire	strikeout
predate	precedent
sustainable	nourish
avaricious	greediness
dictate	dictation
trash	debris
sun	insolation
blatant	blare
think	guess
idiomatic	parlance
proprietary	owner
reinforce	strengthener
real	reality
derive	lineage
bid	bidder
firm	firmness
measure	valuer
retrench	retrenchment
chunky	dumpiness
grunt	grunter
bookish	study
drive	driveway
ridicule	rib
applicable	apply
burn	combustion
mean	form
research	seeker
twinkle	scintilla
preventive	prevent
list	lister
entrust	regent
evidential	evidence
high	mellowness
assure	aplomb
intend	destination
drag	puller
prefer	preference
adolescent	adolescence
weird	outlandishness
fly	aviator
fast	stationariness
shun	avoidance
fluctuate	swing
use	exploiter
dark	moroseness
establish	initiation
socialize	socialization
rigorous	severity
thoughtful	seriousness
pharmacist	drug
standardize	calibration
watch	perceiver
honorable	honorableness
beetle	mallet
repel	repulsion
chop	cleaver
uneven	unevenness
convertible	change
breathe	respirator
think	idea
tawny	tawniness
crop	pasture
clean	clearness
know	experience
heavy	thickness
voice	voicer
early	earliness
adamant	relentlessness
sift	sifter
align	alignment
stalk	stalker
flaw	blemish
char	scorch
hook	hooker
fleshy	corpulence
snap	center
contentious	dispute
prosthetic	prosthesis
acknowledge	acknowledgment
paw	pawer
classless	egality
earl	earldom
prefectural	prefecture
receivership	liquidator
jest	jocoseness
horn	tusk
preach	sermon
manage	treatment
affirm	affirmation
fiddle	shirk
contest	contestee
sensitive	tenderness
adorable	adorability
refute	disproof
cover	compensation
suffer	agony
balance	halter
adjourn	adjournment
gut	catgut
forgetful	obliviousness
ignorant	ignorantness
endeavor	enterprise
blossom	unfold
acceptable	acceptability
sew	stitcher
central	center
flat	flatterer
exceed	exceedance
prejudice	bias
divide	splitter
lope	canter
coherent	coherence
steer	head
acid	sourness
rig	swindle
plunder	loot
inattentive	negligence
adopt	borrow
conserve	economizer
actual	exist
dwell	lie
alive	animateness
settle	settlement
breed	generation
rate	order
ethical	honorableness
ephemeral	transience
hatch	hatchery
force	ram
gamble	chance
shallow	shoal
swear	deposition
pair	couple
determine	find
solidify	solid
sneaky	furtiveness
idle	stagnation
monopolize	monopolist
assume	insincerity
try	essay
lucrative	moneymaking
enliven	energizer
autonomous	autonomy
seed	seeder
destabilize	destabilization
chatter	jabber
speechless	speechlessness
crab	grouch
caucasian	white
charge	file
limber	pliability
civil	civility
animate	refreshment
pay	wage
stagger	staggerer
fin	flipper
precarious	uncertainty
roast	roaster
remarkable	singularity
press	urgency
speculate	hypothesis
designate	appellation
salvage	salvager
wavy	curliness
sniff	snuffle
wrench	twist
attractive	attraction
clog	backup
sane	sanity
physiologic	physiology
accountant	comptrollership
chronological	chronology
balk	balkiness
quarterly	quarter
impervious	impenetrability
dependent	addiction
studious	studiousness
choir	chorus
tend	lean
moralistic	morality
solicitor	solicitorship
observe	ceremony
momentous	consequence
consummate	consummation
stool	shit
mature	maturation
adjust	adjustment
lunge	hurl
tax	taxer
manageable	oversee
estimate	judgment
wary	wariness
express	expression
smear	smudge
cosmic	universe
smack	relish
possible	possibility
tan	tannery
cancel	cancellation
rush	haste
decoy	bait
incite	instigator
recalcitrant	refractoriness
act	actor
assail	assault
yoke	link
theological	theology
grotesque	freak
varnish	waterproof
brace	aplomb
aimless	vagrancy
rocky	rock
fade	attenuation
slow	deceleration
deep	astuteness
demonic	monster
plow	plowman
serve	servant
shine	radiance
choke	accelerator
dormant	dormancy
cryptic	mystery
transport	carry
childlike	simplicity
shave	shaver
disruptive	disrupt
wholesome	wholesomeness
perishable	perishability
confirm	ratification
break	flop
simmer	boil
limp	hitch
surface	lift
edit	editor
golden	favorableness
arduous	hardness
poisonous	poison
stave	rung
absorb	learner
vary	diversification
salute	greeter
scarce	scarcity
offer	bid
rabbit	lapin
impassive	stoicism
respectable	respectability
ram	rammer
splice	splicer
rectify	correction
plunder	spoil
sip	sipper
critical	criticism
buttery	fulsomeness
flat	flatness
rise	advance
berliner	berlin
enclose	confinement
proper	propriety
subcontract	subcontractor
agitate	turn-on
lurch	shutout
hack	hacker
tone	modulation
spot	stain
urge	goad
clear	open
permissive	permissiveness
reform	reformer
brassy	ostentation
originate	origin
install	installation
oblige	obligation
monumental	repository
heavy	moroseness
attendant	attendance
ascetic	austerity
relationship	relative
spike	lace
navigational	seafaring
digest	condensation
bouncy	bounce
account	accountancy
strange	unfamiliarity
antagonistic	antipathy
pubic	pubis
incendiary	incite
bellow	roarer
prolong	prolongation
love	lovingness
misrepresent	misrepresentation
fishy	suspicion
hulk	giant
recognize	recognition
use	habit
want	privation
body	personification
ironic	irony
remake	makeover
sleek	sleekness
excessive	surpass
christian	christendom
revel	reveler
develop	developer
unsuitable	unsuitability
reassure	reassurance
consign	consignment
listen	hearer
serve	service
plume	feather
break	breaker
gap	breach
interpret	rendition
leery	wariness
poor	poorness
sail	bluejacket
count	numeral
antecedent	ancestor
attract	pull
masochistic	masochism
defensive	maintain
vindicate	apologist
labor	hack
behaviorist	behaviorism
applaud	acclaim
writer	write
braid	pleat
wall	environment
attack	attacker
hyperbolic	hyperbola
harmonize	harmony
glow	gleam
execute	execution
extraneous	extraneousness
obtuse	dullness
healthful	healthfulness
absolutist	absolutism
bushy	shagginess
exploratory	research
form	organization
attest	evidence
dot	stud
andalusian	andalusia
gut	intestine
train	homework
stay	delay
trojan	troy
cogent	cogency
discrete	discreteness
monopolistic	monopoly
reduce	concentration
pound	pestle
appease	pacify
wrest	wrester
bad	speculativeness
subscribe	subscriber
methodist	wesleyan
biblical	bible
masonic	freemason
ascendant	rise
faithless	faithlessness
modern	modernity
extend	offer
carve	sculpture
coarse	vulgarize
organize	arrangement
mindful	mindfulness
arable	arability
confuse	confusion
gorge	scoffer
rearrange	rearrangement
ineffective	ineffectiveness
existential	be
harness	rein
craft	trade
concentric	concentricity
congratulatory	preen
motherly	mother
hypnotic	hypnosis
concord	concordance
diverge	divergence
afford	open
announce	announcer
texan	texas
call	telephone
wane	ebb
touch	disturbance
triple	triplicate
publish	issue
buttery	unction
initiate	initiation
evangelist	evangelism
border	edger
understate	minimization
defenseless	defenselessness
theologian	theology
pledge	pledger
scoff	scoffer
consul	consulship
end	conclusion
vouch	vouchee
ageless	perpetuity
dine	dinner
factor	factorization
unequivocal	unambiguity
advance	innovativeness
melt	liquid
wagnerian	wagner
rehabilitate	reclamation
abstract	abstractionist
sign	signature
ruin	destroyer
divisional	division
still	motionlessness
uninteresting	uninterestingness
fallacious	fallaciousness
pick	cream
advise	notification
present	presenter
scramble	clutter
precede	precession
beggar	indigence
bark	barker
pure	purity
moderator	moderatorship
pause	intermission
waterproof	raincoat
messianic	messiah
water	waterer
forbid	veto
vary	change
stringy	wiriness
ballot	vote
propagate	propagator
truthful	truthfulness
apologize	justification
transpire	transpiration
motorist	car
caucasian	caucasia
ascend	ascender
throw	thrower
progressive	progressiveness
flock	troop
screen	blind
grab	catch
give	idolatry
grieve	sadness
fail	breakdown
multiply	multiplier
incurable	incurability
lance	lancet
peninsular	peninsula
snug	coziness
moderate	moderation
grow	acquire
harmonize	harmonizer
elongate	stretcher
immune	resist
hard	severity
formal	formality
fund	finance
seize	grasp
fabulous	legend
twist	braid
stingy	stinginess
pollute	contaminant
fleshy	heaviness
specialize	specialization
partition	zone
acquire	gainer
paraplegic	paraplegia
zest	nip
propel	impulse
confine	detention
chant	chanter
set	venue
unfriendly	hostility
traitor	treason
claim	claimant
place	venue
improbable	improbability
malaysian	malaysia
cover	screen
colonize	colony
confident	confidence
cultivate	crop
dead	unresponsiveness
acknowledge	receipt
portray	portraiture
generative	reproduce
silent	hush
emphatic	exclaim
burdensome	burdensomeness
snort	snicker
instrument	orchestration
lock	lockage
ambiguous	ambiguity
depart	departer
businesslike	seriousness
amuse	comedy
hang	suspension
delusional	delusion
oil	oiler
lovable	love
complain	gripe
disrespect	contempt
call	career
muzzle	muzzler
wallop	walloper
reciprocal	reciprocality
administrative	administer
overflow	overproduction
seedy	seed
turn	turner
cry	crier
incoherent	incoherence
beneficent	beneficence
dirty	dirt
break	discontinuance
correctional	correction
chubby	plumpness
biochemist	biochemistry
relax	rest
libel	defamer
complicate	complication
variant	discrepancy
jurisdictional	jurisdiction
entail	implication
procure	procurement
extravagant	prodigal
confess	confessor
flaw	defect
nettle	urtication
bite	burn
vary	variation
genuine	authenticity
migrate	migrant
program	schedule
tailor	seam
skateboard	skateboarder
measure	evaluation
man	valet
bide	residency
feisty	gutsiness
end	destination
elaborate	exposition
welsh	wale
retract	retractor
tire	wear
altruistic	selflessness
coastal	seashore
equal	equality
despicable	baseness
queer	riskiness
purify	distillate
critical	criticality
southerly	southernness
bum	shabbiness
viral	virus
see	opinion
digitize	digitizer
angelic	pleasantness
recruit	levy
shroud	pall
bohemian	bohemia
surround	environment
shady	shade
trap	immobilization
spy	snoop
deserve	worth
nascent	birth
upland	highland
adamant	adamance
coast	coaster
kinetic	kinesis
incite	fomentation
wicked	nefariousness
costly	price
head	leader
constituent	constitute
include	inclusion
shrimp	prawn
separate	partition
present	presence
bolshevik	bolshevism
crafty	trickery
protective	protectiveness
babble	chatterer
punch	puncher
favorable	favorableness
fat	productiveness
generalize	generalization
nigerian	niger
inaugurate	begin
extremist	extremism
chill	scare
dethrone	deposition
excavate	dig
heave	heaver
journalist	journalism
bring	conveyer
photography	photograph
still	reliever
sparkle	coruscation
confuse	bewilderment
trip	slip
countless	multitudinousness
curious	curiousness
pop	popper
lift	aggrandizement
delete	deletion
reorganize	reorganization
get	acquirer
abhorrent	repel
behave	bear
fowl	fowler
antagonistic	hostility
choke	choker
rank	richness
fluent	smoothness
balance	balancer
bahamian	bahamas
collaborative	collaborate
carbonate	carbonation
officiate	umpirage
confirm	confirmation
stand	standee
fawn	sycophant
christian	jesus
letter	letterer
introduce	presenter
command	commander
disturb	worry
tempt	invitation
municipal	municipality
spike	fortification
adulterous	adultery
detach	detachment
stick	spine
likely	likelihood
rough	roughness
dorsal	back
austere	sternness
reach	liaison
load	cargo
dissident	dissenter
tug	energy
cold	triteness
regret	sorrow
inhibit	suppression
corrode	rust
slope	inclination
starry	star
fluoresce	fluorescence
rebel	rebellion
essential	essentiality
afghani	pashto
distribute	dispenser
sledgehammer	maul
attendant	result
lavender	lilac
tie	draw
missionary	deputation
bet	gamble
test	examination
stimulate	energy
specialist	specialism
mark	marker
equal	counterweight
assume	usurpation
divergent	divergence
dorsal	dorsum
ownership	owner
icky	bullshit
sail	cruise
torture	torturer
settle	colony
himalayan	himalaya
slant	pitch
impressive	impress
reconstructive	restore
enroll	registration
subcontract	job
gamble	gambler
shield	cover
exploratory	explore
assign	assignment
talk	verbalization
indemnify	indemnity
bloom	flower
detail	elaborateness
choral	chorus
light	barge
indeterminate	indefiniteness
override	preponderate
crafty	dodger
bond	alliance
pluck	pick
accept	adoption
consider	deliberation
cheek	impudence
age	longevity
detect	discovery
rare	uncommonness
tweak	pinch
confront	boldness
docile	docility
travel	locomotion
pale	paleness
cloudy	cloud
iconoclastic	iconoclasm
convert	converter
pet	caress
remain	end
fudge	finagler
name	identification
dull	dullness
privilege	prerogative
reader	readership
interrogate	inquisitor
prosecute	prosecution
spell	significance
meet	fill
impersonal	disinterest
insincere	insincerity
load	adulterant
tie	binder
reason	rationality
hesitate	pause
ascend	rise
accept	acceptation
spike	ear
resemble	resemblance
daze	grogginess
hyperbolic	hyperbole
condition	conditioner
support	back
retaliatory	revenge
recluse	reclusiveness
store	storage
cast	mold
common	commonness
harsh	severity
orbital	orbit
electrify	electricity
lag	slowdown
falsify	deflection
erroneous	erroneousness
molecular	atom
bankable	bank
maximize	utmost
age	agedness
encroach	invasion
withhold	withholder
gymnastic	gymnastics
step	footprint
hurl	cast
restore	renovation
purposeful	purposefulness
verse	poet
territorial	territoriality
compress	constrictor
expect	expectation
homicidal	homicide
photographic	photography
wash	washer
battle	combatant
voice	sonant
stoic	stoicism
score	marker
prevail	predomination
steer	bear
harass	instigator
abominable	abhorrence
casual	casualness
trip	tripper
resurrect	resurrection
monopoly	monopolist
confuse	discomfiture
stipulate	specification
wrench	spin
pale	lividness
jet	fountain
burn	incinerator
dowdy	dowdiness
blueprint	draft
smart	brightness
spurt	jet
legislate	enactment
identify	identification
swank	chic
antique	antiquity
circuit	tour
brawl	wrangler
expedient	opportunism
politician	politics
vicar	vicariate
energetic	energy
pollute	contamination
detail	contingent
publish	publisher
insular	insulation
homogeneous	homogeny
regular	regularity
hale	wholeness
skipper	master
scrape	scraper
perceptive	insight
oblige	bind
trail	trailer
promote	promoter
informative	inform
treat	treatment
incongruous	incongruity
hex	enchantress
like	likeness
scuffle	hassle
celestial	quintessence
shout	cry
rate	evaluation
reactive	reactivity
religious	religion
pry	lever
reptilian	reptile
eminent	eminence
impede	hindrance
aggressive	belligerence
roll	roller
stooge	butt
contribute	subscriber
prefix	prefixation
gravitational	gravity
illustrious	greatness
erect	verticality
interpret	interpreter
barometric	barometer
model	sit
blasphemous	sacrilegiousness
puffy	swell
common	usualness
pull	draft
endless	endlessness
rigorous	strictness
harmonious	consonance
grate	grater
home	dwell
kill	eradication
ascetic	abstainer
reality	realist
tire	hack
merciless	cruelty
watery	wateriness
ignore	snub
melodious	music
arch	curvature
shear	shearer
enliven	vivification
heavy	burdensomeness
critical	critic
commend	approval
posterior	buttock
type	typewriter
abort	abortion
legato	smoothness
jag	jaggedness
agile	adeptness
glacial	glaciation
criminal	felony
fluctuate	waver
concoct	concoction
crazy	folly
archivist	archive
stool	toilet
populate	dwell
administer	dispensary
close	shutter
raid	foray
sterilize	neuter
draw	draftsman
affirm	assertion
promulgate	promulgation
quote	citation
ferment	zymosis
persistent	lastingness
sapphire	azure
hypnotize	hypnotist
saboteur	diversion
feasible	executability
legislator	legislatorship
haul	draw
natural	naturalness
accumulate	accumulation
black	infamy
exude	exudate
repetitive	recur
glaze	radiance
point	cursor
exuberant	profusion
recruit	recruitment
stun	stupefaction
rant	rave
blast	shoot
antiseptic	asepsis
surly	temper
rickety	shake
call	caller
republish	republication
commute	exchange
preach	advocacy
falter	hesitation
angular	angle
analyze	dissection
creepy	creepiness
ephemeral	brevity
roll	flap
amateurish	amateurishness
disintegrate	decay
react	reactant
concede	profession
together	togetherness
snip	pruner
dry	prohibition
defray	payment
guilty	guilt
localize	focalization
flank	flanker
destroy	destruction
elaborate	elaboration
buckle	clasp
light	illumination
annual	year
monthly	month
protect	protection
foul	stain
escape	escapist
busy	occupation
slap	slapper
service	overhaul
despotic	tyrant
poor	poverty
appropriate	capture
convict	conviction
buzz	buzzer
blend	fusion
tug	tugboat
placid	smoothness
affirm	avowal
stool	tiller
untie	undoer
continuous	continuousness
borrow	borrower
plumb	bathymetry
irregular	abnormality
volatile	volatilize
crave	hunger
wail	whimper
feel	spirit
sketch	sketcher
magnify	magnitude
rest	breath
basal	basis
back	support
facial	face
rotate	rotation
gaseous	gas
traverse	cross
chute	parachutist
evolve	development
blackmail	pressure
tithe	tither
import	importer
invade	invasion
gastric	abdomen
report	explanation
feign	pretense
botch	fluff
bawdy	ribald
obliterate	annihilation
glum	moroseness
precipitate	precipitation
vow	consecration
cozy	informality
enigmatic	mystery
account	calculation
blue	prude
aboriginal	aborigine
encroach	violation
prophesy	prophet
immediate	immediacy
injectable	inject
name	designation
pigment	pigmentation
hairdresser	hairdo
grumble	growler
exclusive	bar
head	headship
enormous	enormity
deal	hand
depressant	sedative
be	organism
shadow	shade
roll	straggler
grieve	sorrow
interview	interviewer
saturate	purity
melodious	melodiousness
clarify	elucidation
aerodynamic	aeromechanics
unjust	injustice
involve	involvement
skipper	captain
collateral	verify
moderate	moderator
spousal	spouse
debatable	trouble
polygamy	polygamist
autumnal	fall
contend	fight
bombard	barrage
infiltrate	percolation
insecure	insecurity
scallop	cutlet
harden	sclerosis
elder	eldership
grind	molar
chunky	squatness
search	seeker
synchronize	synchronization
promise	promisee
gelatinous	gelatin
improvise	makeshift
enumerate	detail
permeate	dispersion
destroy	ruin
quote	quotation
specify	determinant
gladden	joy
cordial	amity
alibi	excuse
invalidate	nothingness
beg	beggary
lodge	lodgment
phonetic	phonetics
review	retrospection
venetian	venice
give	givenness
sanitary	sanitariness
evert	eversion
eject	expulsion
judge	trial
devolve	degeneration
unaware	unknowingness
index	indexer
interrupt	interrupter
scaly	scale
elusive	elusiveness
squirt	expulsion
observe	observation
share	partaker
noisy	noise
rickety	rachitis
emanate	emanation
chadian	chad
concentrate	assiduity
devious	deceptiveness
innocent	blamelessness
genetic	genetics
regiment	regimentation
nutritional	nutriment
nourish	nutriment
transport	dispatch
knife	stab
replace	substitute
anomaly	anomalist
valuable	invaluableness
hurt	ache
lace	lacer
portly	corpulence
psychologist	psychology
lecture	lecturer
function	operation
tempt	solicitation
foment	fomentation
indistinct	indistinctness
sow	seed
flammable	flammability
web	network
examiner	inspectorship
alter	spay
blame	incrimination
lounge	sofa
route	path
wavy	wave
burn	fire
oceanic	ocean
braid	lace
unlikely	unlikelihood
fallacious	fallacy
drive	impel
hope	promise
coerce	imperativeness
check	catch
strangle	choke
defiant	defiance
absolve	clarity
pluck	pinch
excite	energy
conduct	lead
shape	formation
stimulate	excitation
cute	preciosity
legitimate	legitimation
musician	music
belly	roundedness
balance	equilibrium
operate	operation
enter	entrance
press	urge
blast	bang
marry	marriage
tie	evenness
tap	rap
suck	sucker
dissolve	solvent
auspicious	auspiciousness
relate	relatedness
engineer	locomotive
leaky	escape
pollinate	pollination
adjourn	respite
belgian	belgium
worldly	worldliness
prince	principality
belly	protuberance
clear	elucidation
contemptuous	condescension
populate	population
suppress	inhibition
mobilize	circulation
rusty	rust
learn	discovery
credit	recognition
harry	ravage
gripe	crab
macedonian	macedonia
attractive	attract
preach	advocate
wallpaper	paper
pay	payer
falter	waverer
estonian	estonia
full	fullness
artistic	artist
low	depressor
expressive	express
substitute	substitution
slender	slenderness
selective	selectivity
dramatize	dramatization
haitian	haiti
infectious	infection
exemplify	example
modify	modification
firm	steadiness
cook	cooker
balloon	balloonist
severe	severity
national	nationality
drink	alcoholic
acute	acuteness
deduce	derivation
diversify	diversification
choreograph	choreographer
inconsiderate	inconsideration
atypical	atypicality
lean	meagerness
replaceable	replaceability
assign	specification
raise	leaven
amenable	tractability
convulsive	convulse
wheel	wheeler
verbal	verb
dramatic	drama
contagious	contagion
tend	care
meet	gather
wooden	woodenness
assure	assurance
understate	unpretentiousness
sweet	sweetness
demonstrative	prove
fix	rigidity
salt	salter
variant	vary
shadow	darkness
fiddle	violinist
stand	position
read	reader
remember	memory
meet	encounter
correct	correctness
countless	battalion
rid	elimination
alien	strange
altruistic	altruism
invade	occupier
grow	agriculturist
boisterous	boisterousness
intend	intention
mimic	mime
decide	settler
hex	enchanter
functional	functionality
pacify	pacification
refrain	forbearance
magnetic	magnet
pollinate	pollinator
bumble	hesitation
natural	innateness
modal	mode
stretch	reach
shape	constitution
improvise	extemporization
indefinite	indefiniteness
resist	holdout
gangster	gang
collar	apprehension
humble	humbleness
condense	condenser
allow	granter
generous	generosity
opine	opinion
corrupt	spoliation
autistic	autism
crop	grazier
guess	guesser
supernatural	supernaturalism
angelic	angel
atheistic	atheism
keep	preservation
categorize	classification
total	summation
omnipresent	ubiquity
smother	suffocation
disable	disability
renew	tonic
serve	attendant
derivative	derive
skewer	spit
exemplify	exemplification
force	campaign
deflect	deflector
tear	snap
revolve	rotation
ecological	ecology
stagnate	stagnation
codify	codification
equate	equation
bumble	stammerer
hit	contact
abhorrent	disgust
foreground	highlighter
predict	forecaster
weak	weakness
call	ring
curse	damnation
tease	tantalizer
demonic	unholiness
brackish	brininess
forgetful	forgetfulness
sweep	broom
umbilical	navel
remove	withdrawal
raw	tenderness
theocratic	theocracy
keynesian	keynes
short	improvidence
arrange	agreement
heavy	heft
verify	verification
mention	mentioner
mention	citation
authoritarian	imperiousness
hairless	hairlessness
boastful	brag
inappropriate	inappropriateness
whine	screech
reach	attainment
duel	dueler
feeble	infirmity
bombastic	turgidity
defender	care
decay	decadent
rent	lease
encourage	encouragement
incompetent	incompetence
emit	emitter
remove	removal
digest	digestion
fantastic	wonder
search	searcher
neat	tidiness
superficial	superficiality
cometary	comet
prone	proneness
skirmish	skirmisher
trail	train
consign	commitment
abrogate	abrogator
think	cogitation
effect	effecter
irish	ireland
discover	discovery
improvise	improvisation
contend	fighter
godless	irreverence
retrospective	review
presidential	presidency
middle	center
govern	rule
eliminate	destruction
psychic	soul
psalm	psalmist
contemptuous	contempt
scheme	connivance
distinct	otherness
hunt	hunter
arrive	arrival
comment	notice
emblematic	emblem
buzz	doorbell
percussionist	percussion
methodist	wesley
argue	argumentation
conspire	collusion
crude	crudeness
digestible	digest
heavy	profoundness
corrode	corrosion
chronicle	history
electoral	election
dress	apparel
refuse	declination
perform	actor
infective	pathogen
characterize	quality
clerk	bookkeeping
cut	carve
actual	actuality
oncologist	oncology
reclaim	reclamation
satirize	parody
trade	merchandise
haul	hauler
neighbor	vicinity
enclose	enclosure
barb	seta
obstruct	blockage
rectify	redress
connect	connection
unify	fusion
pose	impersonator
export	exporter
filter	strainer
inexperienced	inexperience
hydrate	hydration
action	summon
pertinent	applicability
jeweler	jewel
wall	palisade
compact	compaction
invade	infestation
rave	effusion
wallow	rejoice
speculate	supposition
monstrous	freak
fleet	moment
quiver	quaker
actual	literalness
channel	canal
reciprocate	reciprocation
flat	blandishment
close	blockage
vital	vitalness
achieve	accomplishment
satisfy	satisfier
small	smallness
president	chairmanship
impatient	impatience
form	component
culminate	completion
float	flotation
visualize	effigy
predominate	preponderance
dependable	dependability
illustrate	illustrator
patent	patency
stuff	taxidermist
fawn	truckle
bring	transportation
easy	profligacy
fictional	fiction
therapist	therapy
record	tape
sweat	perspirer
romanian	romania
color	darkness
close	secrete
amniotic	amnion
easy	slatternliness
brother	brotherhood
save	economy
preemptive	preempt
pacify	comforter
invalidate	nullification
transport	transportation
unresolved	noise
administer	dispensation
marginalize	marginalization
analogous	analogy
stem	stemmer
disengage	withdrawal
warehouse	warehouser
amend	amendment
repeat	restatement
disassociate	dissociation
nibble	nybble
drink	swallow
clog	congestion
sparkle	twinkle
palsy	paralysis
grade	gradation
provide	provision
port	porter
tenable	reasonableness
scatter	dust
extricate	unsnarl
warehouse	reposit
shock	indignation
enjoy	enjoyment
guitarist	guitar
observant	notice
blunt	starkness
reluctant	reluctance
deck	floor
auxiliary	subordinateness
gravelly	pebble
categorical	class
nip	clip
careful	economy
try	attempt
incur	incursion
whale	whaler
general	generalization
settle	colonization
propose	proposal
cameroonian	cameroon
frequent	haunt
pace	step
bowl	bowler
digestible	digestibility
leery	suspicion
instrument	instrumentality
courtly	stateliness
designate	designation
type	typist
deprive	pauperization
separate	watershed
consummate	maestro
become	decency
tumble	tumbler
plural	plurality
count	matter
dry	dispassion
cohesive	coherence
continuous	continuity
swear	oath
bulky	bulk
mournful	mournfulness
edible	edibility
avid	ardor
challenge	rival
chariot	charioteer
rear	rearward
durable	lastingness
loosen	relaxation
tonal	key
invalidate	invalidator
abstract	abstractor
subscribe	support
inactive	inactiveness
sublime	sublimity
impart	conduction
inactive	inaction
sunburn	tan
trash	rubbish
publish	release
dilate	dilator
indulge	luxury
grind	land
lunatic	lunacy
company	companion
devolve	degeneracy
embrace	inclusion
spank	paddle
swim	swimmer
predictive	prognosis
prepare	trainee
serviceable	serviceability
alien	foreigner
open	orifice
complete	finish
broad	enormousness
sufficient	enough
burst	split
captive	captivity
big	bounty
deplete	lowness
siberian	siberia
persecute	oppressor
backward	denseness
rickety	wobble
recommend	recommendation
fix	ready
introduce	acquaintance
thin	dilutant
concede	confession
glamorous	glamor
operate	run
incriminate	incrimination
discriminate	differentiator
chancellor	chancellorship
determine	influence
propose	suggestion
withdraw	drawee
counselor	counselorship
assemble	gather
sugary	sugariness
excellent	excellence
insignificant	insignificance
board	boarder
debate	deliberation
specify	particularization
licentious	license
war	warrior
dally	flirt
combustible	burn
carpenter	carpentry
transgress	violator
peddle	peddler
bumpy	bumpiness
spray	atomizer
shorten	shortener
congregate	congregation
rock	sway
sudden	abruptness
levy	imposition
clandestine	underground
dismiss	disregard
deteriorate	deterioration
spot	spotter
taciturn	reserve
postulate	postulator
concentrate	focus
spare	trim
award	grantee
advise	tell
assail	rape
sour	vinegar
tell	relation
compliant	comply
chewy	chew
dispose	disposal
qualify	qualifier
presidential	president
compassionate	compassion
solid	solidity
attendant	accompaniment
crab	crankiness
unionize	unionization
ancestral	birthright
messy	mess
play	plaything
prod	instigator
barb	prickliness
slug	slugger
swear	swearer
superior	transcendence
stabilize	stabilizer
inject	injection
torture	crucifixion
captain	captainship
immunological	immunology
relax	easiness
restrict	restrainer
awkward	inaptness
forage	eatage
joint	articulation
tumble	spill
cover	extent
hold	garter
offer	offerer
consult	adviser
squat	squatness
ample	profusion
infuriate	craze
harass	harasser
terrorize	terrorization
chase	trail
curious	foreignness
revise	revision
drink	drinker
recover	restitution
forbid	prohibition
master	command
teach	education
sled	sledder
control	restrainer
coincide	accompaniment
train	track
strengthen	fortification
roll	hiker
commemorative	commemorate
commandeer	piracy
leader	leadership
bind	margin
slovakian	slovakia
interstitial	interstice
ministerial	minister
chant	intonation
even	regularity
inhale	inhalant
torment	anguish
anxious	restlessness
suburban	suburbanize
burp	belch
red	scarlet
bare	bareness
muster	conscription
embarrass	abashment
psychedelic	psychedelia
testify	evidence
fiery	fieriness
formidable	formidability
suffocate	asphyxia
attendant	resultant
decode	decoder
coincident	coincide
able	ability
global	earth
insidious	perniciousness
boo	hiss
daily	day
unsavory	disgustingness
unavailable	inaccessibility
conspire	conspiracy
blend	mix
lieutenant	lieutenancy
rationalize	systematization
drum	drummer
get	acquire
bear	pallbearer
homestead	squat
asian	asia
watch	lookout
dead	deadness
algerian	algeria
unknown	strange
prefer	preferment
paternalistic	paternalism
monochromatic	monochromacy
rewrite	redact
indicate	cursor
cranky	testiness
distant	farness
diseased	pathology
mindless	inanity
perceptible	perceptibility
unconvincing	flimsiness
earthy	earth
dissolve	thaw
mortuary	morgue
quarrel	combatant
homoerotic	homosexuality
insert	enclosure
terrify	terrorization
fund	support
fink	deserter
take	pick
ornithologist	ornithology
transpose	transposition
fee	self-feeder
alive	animation
refute	rebutter
sharpen	taper
academic	pedantry
bill	poster
reduce	cutback
chatter	balderdash
reap	crop
reach	contact
rub	scabies
unstable	instability
recluse	hermit
moonshine	bootlegger
buggy	bugginess
mutiny	mutineer
poetic	poet
chill	frisson
disagree	dispute
cuban	cuba
irregular	maverick
hallucinogenic	hallucinogen
support	patron
relax	liberalization
downright	downrightness
thrill	thriller
see	eyesight
patronize	trade
grade	scorekeeper
dreamy	dream
unique	singularity
homicidal	murderousness
score	hit
vacant	vacate
call	birdcall
reasonable	reasonableness
illustrate	illustration
drowsy	yawn
appoint	appointment
prepare	train
troublesome	troublesomeness
discipline	trainee
polar	pole
motive	motor
explore	exploration
disturb	disturbance
probationary	provision
hurt	detriment
black	calamity
integrate	incorporation
philosopher	doctrine
fly	flight
glad	gladness
minor	smallness
elaborate	exponent
unite	combine
catalyze	catalyst
motivate	incentive
chase	chaser
changeable	inconstancy
warn	warner
weighty	weight
adversary	antagonism
unresolved	disharmonize
innovative	initiation
union	federal
intrigue	fascination
imitate	copy
waste	thriftlessness
redefine	redefinition
draftsman	draw
voluntary	volunteer
arise	riser
age	senesce
constructive	constructiveness
shelve	shelver
subside	dreg
focal	focus
fabulous	mythology
congratulate	congratulation
gory	sanguine
hide	concealment
originate	originator
pharaonic	pharaoh
port	larboard
dilate	distention
excite	energizer
accept	credence
liberalize	liberalization
grateful	gratefulness
run	course
testimonial	tribute
steer	usher
purse	wrinkle
cosmetic	decoration
deductible	withhold
precious	costliness
generational	generation
clairvoyant	clairvoyance
clear	legibility
bleak	bleakness
humor	indulgence
contribute	contribution
scoff	jeer
buy	purchase
attend	attendance
zest	spiciness
moderate	lead
consume	wastrel
break	downheartedness
fashionable	chic
whiff	whiffer
audit	scrutiny
liquid	fluidity
concede	cession
soft	softness
squelch	put-down
adaptable	adaptability
realize	realization
win	winner
throng	batch
physiologist	physiology
refer	reference
rave	raver
polar	polarity
glorify	idealization
regurgitate	regurgitation
amino	amine
consume	prodigal
awkward	awkwardness
weld	welder
crystalline	pellucidness
detectable	perceive
raft	raftsman
volcanic	volcano
destructive	destroy
corrupt	libertine
downy	downiness
return	rejoinder
raucous	shrillness
minimize	minimum
tick	watch
foreground	highlight
dry	sarcasm
sleep	sleeper
gravitational	gravitate
probationary	probation
call	cry
offset	counterbalance
ameliorate	good
elect	choose
hawk	falconer
psychotherapist	psychotherapy
scrappy	scrappiness
pour	stream
alternate	surrogate
bridal	bride
separate	separatist
waste	overflow
overturn	upset
monogamy	monogamist
brotherly	brother
pronounce	label
tremor	earthquake
hostile	hostility
raven	predation
rational	rationality
chauvinistic	chauvinism
entrepreneur	enterprise
sacrifice	sacrificer
stool	defecator
loose	looseness
dribble	dropper
clog	clot
visualize	fancy
subservient	subservience
moldovan	moldova
black	iniquity
ignorant	ignorance
warn	admonisher
rest	respite
mandate	mandator
kindle	ignition
flush	bloom
lousy	louse
imbue	hue
elongate	elongation
technician	technique
redemptive	redemption
freehold	freeholder
infinitesimal	diminutiveness
travel	journey
serious	seriousness
whistle	whistler
overcast	cloudiness
petition	request
hearty	vigor
hideous	loathsomeness
canvass	poll
anomalous	anomaly
educational	education
permeate	diffuse
glide	slide
geriatric	geriatrics
gut	gutter
catalogue	catalog
clement	mildness
glitter	flicker
throw	jab
wear	clothe
form	constitution
discontinue	cease
thematic	theme
border	boundary
placid	placidity
blister	vesiculation
contaminate	contaminant
impregnable	invulnerability
contest	contester
fester	pu
lock	locker
credible	believe
slime	sludge
tolerate	toleration
round	roundness
testify	attestation
confrontational	confrontation
french	frog
happy	happiness
pay	payee
erase	erasure
analyze	analysis
rare	rarity
liberate	liberator
classify	classifier
learn	skill
humanistic	humanism
manipulate	handle
risk	hazard
mariner	seamanship
launch	launcher
sure	assurance
quarry	pit
distribute	distribution
gay	hilarity
arsonist	arson
abdicate	abdication
unselfish	unselfishness
graduate	alumnus
cool	coolness
hook	solicitation
transgress	transgression
compress	compression
bartender	mixology
reliable	dependability
talk	mouthpiece
groan	groaner
dry	desiccant
slender	delicacy
route	road
presuppose	presupposition
relate	relation
accept	acceptance
gag	suffocation
exhaust	discharge
connective	associate
manage	care
valiant	heroism
locomotive	travel
unsound	unsoundness
presidency	president
ageless	eternity
associate	colligation
configure	configuration
press	cheer
choice	fineness
bantam	diminutive
glacial	glacier
applicable	applicability
patch	mend
veto	negative
coerce	power
seduce	seduction
purify	distillation
repair	haunt
easy	gradualness
backfire	backlash
revolutionize	revolution
devilish	prankishness
analyze	examen
supervisory	oversee
go	procedure
impound	pound
arrogant	ego
count	dependence
tilt	joust
satisfy	gratification
want	wanter
barbarous	savageness
hill	mound
barricade	block
tie	tier
embrace	encompassment
receptive	receive
parallel	analogue
overlord	mastership
stride	pace
splat	spatter
tubal	tube
suppress	suppressor
discontinue	cessation
profane	profaneness
diplomatic	diplomat
fungal	fungus
delegate	deputation
cool	chilliness
crook	curvature
dear	earnestness
adjunct	assistant
slice	piece
think	thinker
childhood	child
vote	voter
groan	whiner
unify	whole
maim	mutilator
divide	divider
arm	armament
convertible	convert
etch	etcher
hex	witch
pinch	squeeze
exhaustive	thoroughness
control	command
master	mastership
hop	skip
impressionist	impressionism
theorist	hypothesis
extract	extraction
bony	bone
abundant	abundance
cloudy	cloudiness
represent	interpreter
want	lack
mention	name
fair	comeliness
barricade	blockade
crack	wisecrack
meet	play
season	veteran
travel	motion
reappear	reappearance
unconnected	unconnectedness
tender	tenderness
friendless	outcast
sensitive	sense
smoke	smoker
interchange	switch
knowledgeable	knowledgeability
assertive	assertiveness
desire	wanter
broadcast	broadcaster
digestive	digest
afghani	afghan
chastise	castigation
argue	controversy
assume	imposter
incriminate	implication
twist	sophistication
frolic	romper
uproot	extirpation
variant	version
discernible	evidence
callous	unfeelingness
traverse	denier
insistent	recur
cultural	culture
swerve	yaw
trouble	inconvenience
assume	fake
regenerate	rejuvenation
rule	decree
germinal	originate
visit	call
bad	speculate
suspend	brace
torment	agony
get	acquisition
baffle	confusion
nuke	atomization
telescopic	telescope
lush	succulence
conceivable	conceivableness
modulate	transition
meaty	meat
prankster	antic
pose	portrayal
topple	spill
mystic	mysticism
intern	internist
dysfunctional	dysfunction
deter	hindrance
credible	credibility
rental	lease
buy	buyer
immoral	immorality
parole	probationer
coincident	concur
precedent	precede
dally	dallier
rob	robbery
run	functionality
widen	extension
subsidize	subsidization
optimist	optimism
connect	linkage
insightful	insightfulness
bicycle	cyclist
affect	impact
appraise	measure
avoid	avoidance
curl	wave
clerical	clerk
smother	asphyxia
durable	perdurability
barricade	roadblock
crusade	campaign
superstitious	superstition
err	erroneousness
bavarian	bavaria
dramatic	play
need	necessity
measurable	quantifiability
deprive	privation
elephantine	giant
taxable	taxability
surfeit	repletion
jest	jocundity
blackmailer	extortion
progress	advancement
dangerous	seriousness
stain	stainer
erotic	eros
essayist	essay
undesirable	unsuitability
twig	branchlet
apply	applicant
sublime	sublimate
weave	weaver
ordain	consecration
verify	voucher
propel	propeller
sincere	sincerity
earthly	earth
sign	signer
amateurish	amateur
technical	technicality
crush	demolition
axiomatic	axiom
start	inauguration
insomniac	wakefulness
crump	scrunch
faithful	fidelity
honest	honesty
factor	divisor
insulate	insulation
disparage	detractor
timely	opportuneness
sponsor	patron
regress	regression
humiliate	humiliation
defect	deserter
womanhood	woman
odd	oddity
dream	daydreamer
impart	conductor
partake	share
blatant	blatancy
run	footrace
choose	choice
money	coiner
breathless	dyspnea
peddle	pitch
plan	project
line	wrinkle
dense	retardation
excuse	explanation
potent	potency
stem	root
anticipate	obviation
sock	knock
intrude	intruder
unattractive	unattractiveness
technical	technology
incite	incitation
stride	strider
citizen	citizenship
telepathic	telepathy
oppose	resistance
present	representation
incandescent	incandescence
offer	suggestion
disorderly	hugger-mugger
apprehend	apprehension
stalwart	stoutness
chew	jaw
gravelly	shingle
introduce	invention
rape	spoil
shrill	shrillness
defect	abandonment
ache	pain
plain	plainness
synthetic	synthesis
pursuant	pursue
unwary	unwariness
summon	citation
present	presentation
farcical	absurdity
curator	curatorship
intensify	saturation
discontinue	discontinuance
propagate	propagation
impartial	impartiality
intestinal	intestine
lavish	munificence
cover	bind
compound	combine
overthrow	subversion
stipulate	circumstance
review	survey
nationalist	patriot
unquestionable	indisputability
indisputable	indisputability
farcical	farce
compile	compilation
order	orderer
compulsive	compulsiveness
mire	sludge
animate	animateness
cross	crisscross
celebrate	celebration
gore	bloodshed
oriental	east
combine	trust
endow	dower
insensitive	insensitivity
fall	faller
resist	fender
file	register
bouncy	resilience
putter	tinker
persistent	persist
memorize	memory
litter	litterer
newtonian	newton
equatorial	equator
branch	furcation
fractious	unruliness
apparent	obviousness
hush	muteness
nibble	nibbler
stationary	stationariness
panhandle	panhandler
liege	vassal
pinch	nip
strike	striker
instructional	education
equivocal	ambiguity
grade	mark
dogmatic	dogma
allow	allowance
graduate	commencement
inert	inertness
protagonist	agony
unwieldy	awkwardness
skid	slide
male	manfulness
rubbery	rubber
random	randomness
stoop	stooper
garden	gardener
coarse	commonalty
qualify	quality
anoint	oil
procedural	routine
find	feel
choose	picker
judgmental	judgment
scholastic	scholasticism
improper	impropriety
mutinous	mutiny
covert	hiddenness
spur	goad
worsen	aggravation
naked	openness
influential	influence
bootleg	contraband
unpalatable	unpalatability
blunt	frankness
automatic	automatize
elude	slip
tonic	tonicity
portray	paint
culminate	culmination
fractional	fraction
film	take
widowhood	widow
analyze	analyzer
radical	base
uneasy	malaise
procure	procurer
isolate	insulation
suggest	inkling
digest	digester
entice	tempter
carve	sculptor
relegate	classification
company	escort
callous	callosity
infuse	infusion
aberrant	pervert
secede	breakaway
ample	ampleness
proclaim	announcement
deceptive	deceive
fit	adjustment
solve	solution
divine	god
corneal	cornea
level	raze
earth	ground
disruptive	turbulence
climb	ascent
combatant	battle
capture	smoothie
back	rear
same	monotony
personhood	person
rut	estrus
integral	entirety
corrupt	orgy
reduce	decrease
content	contentedness
climb	mounter
intern	internment
troll	round
available	use
barter	barterer
fluctuate	fluctuation
lucky	luck
tell	narration
erupt	outburst
oppressive	tyrant
solvent	clear
discriminatory	predilection
tip	gratuity
dilute	cut
barb	barbel
experiment	experimenter
rancid	rancidness
sustain	sustenance
disagree	dissenter
stiff	stiffness
throw	potter
herbal	herb
inert	languor
callus	callosity
assign	attribution
steer	maneuver
quote	quoter
dark	moodiness
orchestrate	orchestrator
zairean	congo
imaginative	invent
sliver	chip
total	number
pretentious	pretense
varnish	varnisher
account	explanation
grammatical	grammar
disarm	pacifist
adolescent	adolesce
hike	hiker
traverse	defense
parenthood	parent
reinstate	reinstatement
hop	grounder
future	futurity
arbitrary	flightiness
bleach	bleacher
measurable	measure
tell	narrative
budgetary	budget
focus	focalization
flat	monotone
falsify	falsity
quadruple	quadruplicate
dealer	franchise
rant	chatterer
referee	umpirage
chromosomal	chromosome
greasy	sebum
prostrate	prostration
pose	affectation
shanghai	shanghaier
unlawful	unlawfulness
pare	parer
abrupt	abruptness
aristocratic	gentry
illogical	illogicality
impressive	affect
pride	congratulation
caustic	corrode
align	coordination
epidemiologic	epidemiology
social	sociality
transfer	reassignment
consign	consigner
beat	thrash
sling	slinger
acrobatic	sport
quarrel	disputant
toy	twiddler
transform	transformer
like	similarity
infrequent	rarity
loath	reluctance
watery	water
barbarian	peasant
enlighten	enlightenment
perceptual	sense
postpone	putoff
caucasian	caucasus
document	documentation
bootleg	moonshine
fly	navigation
excellent	excel
parry	counterpunch
belong	property
weak	helplessness
chuck	pass
organize	organization
feign	hypocrite
defend	defense
arrange	order
dress	array
divine	divinity
horrid	awfulness
bicycle	pedaler
market	sell
ambitious	ambition
normal	normality
particular	peculiarity
dimensional	dimensionality
raise	erect
easy	leisureliness
choose	preferment
gusty	puff
intact	intactness
rush	hurry
have	experience
miss	lack
entice	lure
abstract	abstraction
subvert	subversion
rend	rip
fearful	frightfulness
overreact	overreaction
blunt	dullness
friendless	friendlessness
indebted	indebtedness
mail	send
tactical	tactic
revolutionary	revolution
exorbitant	exorbitance
dramatize	drama
recur	repeat
hang	hanger
collaborate	cooperation
incriminate	crime
view	position
palatial	palace
allegorical	fable
cheer	urge
resurgent	revival
costume	costumier
untidy	untidiness
colonize	colonization
thrash	flail
communicate	communication
frigid	coldness
substitute	replacement
angelic	saint
sneak	prowler
drink	liquor
look	appearance
hyperactive	overactivity
scout	rover
speed	speeder
paint	painter
hopeful	aspirant
react	reaction
adhere	bind
typify	representation
inform	witness
woo	suitor
beat	flap
review	commentator
scrupulous	scrupulousness
spartan	sparta
choke	strangulation
jest	jocosity
total	sum
suffocate	suffocation
dissociate	dissociation
anonymous	anonymity
conversant	acquaintance
coordinate	interconnection
nosy	nosiness
thwart	obstructionist
shock	daze
lead	usher
view	consideration
flaunt	ostentation
unfold	open
train	education
tease	boo
primitive	crudeness
duke	duchy
auxiliary	subordinate
repel	drive
direct	directive
unsavory	offensiveness
fabled	legend
demonstrable	incontrovertibility
authorize	pass
corroborate	documentation
eligible	eligibility
boast	vaunt
trot	jogger
angry	tempestuousness
torment	crucifixion
slow	slump
methodical	method
grumble	growl
unwilling	unwillingness
greasy	greasiness
attributable	impute
muscle	brawn
salvage	rescuer
detail	particularization
obliterate	eradication
promote	promotion
scar	pock
shoot	germ
shake	wag
reunite	reunion
vindicate	defense
change	alteration
hope	hoper
gradual	gradualness
melodious	musicality
stimulative	stimulate
dumb	mute
consult	consultation
hideous	awfulness
retard	slowdown
consign	charge
palatable	palatability
exhaust	release
concentrate	concentration
poll	pollster
repeat	reduplication
fiscal	finance
messy	untidiness
trespass	intruder
prejudice	discriminate
mumble	gingiva
glow	freshness
mail	mailer
collect	pickup
tone	toner
external	internationality
obtain	obtainment
betray	informer
plot	schemer
elective	elect
productive	productiveness
free	liberty
internationalist	internationalism
calm	calmness
conscientious	conscience
active	animation
realistic	realist
neck	caress
abstract	abstractness
tone	intonation
bind	binder
arguable	debate
persuade	persuader
separate	rupture
sacrifice	forfeit
indulge	indulgence
fruity	fruit
microbial	microbe
reject	refusal
crop	graze
change	conversion
dampen	damp
substantial	substance
plead	advocate
mortgage	mortgagee
benefit	humanitarian
metabolic	metamorphosis
materialism	materialist
bind	attachment
code	encode
bark	pooch
disreputable	unrespectability
fore	arboriculture
dab	pat
inevitable	inevitability
retentive	remember
hurt	discourtesy
oceanographer	oceanography
reunify	reunion
feel	finger
affable	amity
tarnish	mark
devise	devisee
trotsky	trotskyite
typify	epitome
principal	headship
depreciate	devaluation
shop	browser
enroll	recruiter
promise	assurance
lunge	jab
general	generalship
cardiologist	cardiology
agreeable	agree
journalistic	journalism
hedge	circumvention
jazzy	jazz
baffle	problem
clot	curdle
thicken	inspissation
stream	rivulet
spy	sight
vascular	vascularity
clear	readability
panelist	jury
pant	gasp
order	decree
practice	custom
tuck	tucker
authenticate	authentication
orphan	orphanage
cuddle	caress
glide	glider
pose	poseur
iridescent	iridesce
ignite	ignition
balmy	mildness
powerful	power
storm	surprise
unionize	organization
inbound	inwardness
luminescent	luminescence
grapple	wrestle
tasty	pleasingness
infancy	baby
tone	shade
great	greatness
gay	jollity
conscientious	conscientiousness
clerk	clerkship
dense	concentration
snap	snarl
distant	distance
barbarian	savage
stock	store
interview	interviewee
grill	grillroom
scathing	vilify
hardy	stoutness
blow	blower
shudder	tremor
hysterical	hysteria
help	assistant
worsen	deterioration
transform	transformation
ukrainian	ukraine
hover	oscillation
uncontrollable	refractoriness
arch	condescension
dress	dresser
fleece	sheepskin
hazardous	riskiness
athletic	athlete
sensible	sensitivity
spoof	parody
formative	imprint
reinforce	support
reduce	reduction
infective	infect
splash	spatter
distribute	distributor
dedicate	dedication
decompose	decay
mechanistic	mechanism
loose	slack
conspiratorial	conspiracy
check	idiot
appeal	appellant
undifferentiated	uniformize
minister	relief
action	suer
flavorful	relish
futile	futility
original	master
contradict	negation
apathetic	apathy
large	largeness
stimulate	stir
respect	regard
draft	outline
arch	impishness
evaluate	judgment
somalian	somalia
unresolved	dissonate
hypnotic	hypnotism
confine	detainee
precise	preciseness
disprove	confutation
active	action
carry	sway
slit	incision
add	addition
distill	distillation
avaricious	avarice
penile	penis
ministerial	curate
pledge	assurance
alcoholic	alcohol
declare	contract
fold	folder
want	need
flow	stream
hitch	catch
defunct	extinction
easygoing	easygoingness
crack	fracture
move	mover
complicate	complicatedness
burden	burthen
abstract	outline
adhere	adhesiveness
nudist	nudism
embarrass	embarrassment
affiliate	affiliation
inclusive	include
abrasive	abrade
boom	stentor
crazy	fad
debunk	repudiation
shallow	shallowness
gloomy	gloominess
suppress	suppression
limp	lameness
rich	impressiveness
idle	looseness
subjective	subjectivity
toxic	toxicity
corrective	chastise
perch	percher
plaster	daub
