mess	military
growth	biology
translate	genetics
spar	cockfighting
evidentiary	law
bum	colloquialism
allegro	music
fuck	slang
linear	mathematics
expeditionary	military
bat	baseball
ethos	anthropology
condemnation	law
theorist	art
tribe	biology
litigant	law
flat	photography
recognition	biology
subject	grammar
make	arithmetic
laterally	anatomy
mean	slang
series	electronics
niche	ecology
cruise	drive
yield	investment
parity	physic
cable	telegraphy
scratch	golf
limitation	law
film	movie
white	chess
abnormal	psychology
tension	literature
convention	diplomacy
cleanup	baseball
injectable	drug
fiddle	music
formulate	chemistry
quiescent	pathology
draw	baseball
draft	write
galley	antiquity
underhand	sport
oral	psychoanalysis
flanker	military
hopelessly	colloquialism
ecological	biology
laurel	greece
rally	badminton
incompatibility	immunology
mechanism	philosophy
grip	car
characteristic	electronics
eagle	golf
stipulation	law
orally	drug
defense	sport
completeness	logic
underlie	print
firewall	colloquialism
drift	mine
shear	plural
grind	baseball
rhyme	poetry
subcontinent	greenland
body	animal
crazy	colloquialism
prescription	medicine
shore	river
measure	prosody
post	ride
host	medicine
mafia	terrorism
colonel	military
fault	badminton
counterintelligence	terrorism
caller	scotland
setup	colloquialism
canoe	sport
seat	dramaturgy
bomb	terrorism
behavior	psychology
gabriel	bible
redemption	corporation
star	dramaturgy
ransom	crime
checkmate	chess
circulation	plant
catalan	spain
rehearsal	psychology
chinese	china
libel	law
erase	record
connection	narcotic
radical	botany
negative	medicine
mandate	law
kick	sport
live	print
plaintiff	law
multiply	arithmetic
landscape	garden
control	archaism
rappel	sport
aesthetic	philosophy
thrush	colloquialism
hybrid	genetics
harmonize	music
rap	music
clarify	cook
blister	botany
habit	psychology
variance	statistic
stuff	slang
fix	cytology
sequester	chemistry
militia	military
ferry	navigation
index	publication
residual	plural
acid	chemistry
strain	physic
warplane	military
nick	slang
twinkie	trademark
epoch	astronomy
staccato	music
key	slang
plow	farm
virgo	astrology
kern	print
interconnection	computer
polymorphism	genetics
fair	baseball
support	military
minimalist	politics
irritate	physiology
major	military
marine	military
intensification	photography
calculate	mathematics
lawyer	law
appropriation	legislature
long	phonetics
donna	italian
style	botany
campaign	africa
naturalism	philosophy
referee	law
progressive	government
resistance	psychiatry
valence	biology
appointment	law
old	linguistics
overhead	seafaring
link	program
stretch	race
winger	football
basic	chemistry
wayland	mythology
establishment	ecology
soup	colloquialism
disintegrate	physic
split	tenpin
inclination	astronomy
lax	phonetics
deputy	france
char	cook
pass	military
level	england
trade	commerce
grill	cook
chastity	religion
accuracy	mathematics
bake	cook
iron	plural
good	comparative
include	chemistry
madly	intensifier
verse	poetry
skate	sport
cool	colloquialism
snafu	acronym
ballplayer	baseball
inflation	cosmology
sector	military
dynamic	physic
attack	military
troll	scandinavia
wilderness	politics
knight	chess
chorus	sing
circus	rome
liability	plural
log	airplane
pole	metallurgy
square	arithmetic
ace	tennis
domicile	law
irish	ireland
imposition	tax
flare	baseball
black	chess
deliberation	plural
commando	military
delusion	psychology
resell	commerce
reproduce	biology
box	sport
spike	botany
outpost	military
cut	box
theater	dramaturgy
sourdough	west
tackle	football
deserve	irony
eye	colloquialism
theme	music
outfielder	softball
safe	baseball
immunity	medicine
modal	statistic
ordinance	law
lacquer	handicraft
curl	scotland
real	economics
significant	statistic
passenger	boat
run	football
citation	law
review	law
shade	art
base	archaism
kick	football
hood	zoology
defense	military
remission	law
simple	archaism
deserter	military
finite	grammar
plea	law
ark	judaism
wash	colloquialism
birdie	golf
halfback	football
bag	hunt
license	law
fissionable	physic
gladiator	rome
castle	chess
inactive	chemistry
enemy	military
libel	tort
more	comparative
prosecution	law
tectonic	geology
change	geology
beat	music
lug	ireland
short	finance
disclaimer	law
contradiction	logic
phalanx	military
groin	construction
drift	ship
showroom	car
legato	music
pyrotechnic	music
synagogue	judaism
localize	medicine
register	music
barge	navigation
quarter	football
order	biology
limit	grammar
chip	seafaring
biologist	biology
lieutenant	military
foot	colloquialism
readiness	military
wind	military
luger	trademark
sharp	music
peacekeeper	military
choreograph	dance
winger	rugby
heel	dance
fly	dramaturgy
swastika	germany
derivative	linguistics
livid	colloquialism
salient	heraldry
convert	chemistry
terribly	colloquialism
resistance	bacteria
vicarious	medicine
ringer	quoit
mathematics	science
sleeper	terrorism
expansion	mathematics
objective	grammar
americana	furniture
conversion	psychiatry
plague	colloquialism
careful	archaism
render	law
minor	theology
relaxation	physiology
decompose	chemistry
eviction	law
sell	commerce
trial	sport
loot	crime
reflexive	grammar
adjust	psychology
squeeze	slang
article	grammar
spy	military
mental	biology
rabbi	hebrew
proposition	logic
largo	music
hurdle	sport
kill	colloquialism
nocturnal	biology
artillery	military
tube	anatomy
front	meteorology
defense	law
ordinary	heraldry
fixation	histology
primitive	anthropology
fine	metallurgy
decree	law
fret	music
put	music
extrapolate	logic
plead	law
aquarius	astrology
casualty	military
midas	greece
devise	law
verdun	france
cultivation	farm
salerno	italy
surge	sport
hole	golf
error	baseball
clinician	psychology
forceps	plural
diet	animal
salve	medicine
hinduism	nepal
factor	arithmetic
compatible	computer
barrister	law
passenger	airplane
clear	commerce
saturate	chemistry
sled	sport
run	crime
synthetic	logic
function	mathematics
stroke	golf
ki	sumer
general	military
hike	sport
adult	animal
imperative	grammar
tao	taoism
id	psychoanalysis
deduce	logic
coach	drive
mantle	zoology
microorganism	animal
drug	medicine
rein	drive
dormant	heraldry
pass	football
ligation	surgery
raise	bridge
evergreen	plant
jirga	pashto
center	basketball
bad	colloquialism
hopeless	colloquialism
compress	biology
heartless	archaism
bed	geology
hack	basketball
string	music
overhand	sport
accretion	astronomy
check	chess
cancer	astrology
call	sport
egg	cook
move	game
passenger	train
prefer	law
affirmation	religion
division	botany
live	intensifier
walkman	trademark
apparatus	anatomy
broadside	navy
contact	electronics
prop	plural
man	colloquialism
slide	geology
rally	squash
season	cook
kibbutz	israel
pot	colloquialism
inertia	physic
handshake	contract
spar	sport
smuggle	commerce
fret	handicraft
woman	colloquialism
breech	plural
verbal	archaism
mouthpiece	colloquialism
chevron	military
queen	chess
pot	slang
lead	print
first	music
parole	law
negation	logic
girdle	plant
brunch	blend
fly	aircraft
aesthetic	art
magenta	italy
captain	military
round	mathematics
vaseline	trademark
dominance	genetics
therein	formality
muster	military
work	plural
extinguish	psychology
disqualify	sport
battery	military
mow	vegetation
state	colloquialism
caisson	military
reversal	law
appear	dramaturgy
fuck	obscenity
persecution	religion
punt	football
expose	photography
commissary	military
bobsled	sport
kidnap	crime
tack	navigation
double	botany
condition	psychology
chink	slang
copyright	literature
velcro	trademark
antigen	immunology
heel	golf
right	geometry
facilitate	physiology
single	botany
add	arithmetic
trap	animal
lucknow	india
lyric	poetry
effect	law
shimmy	dance
testimony	law
pepper	cook
battle	military
enamel	handicraft
hastings	england
butch	disparagement
growth	pathology
dope	electronics
slack	military
projection	psychiatry
whiff	baseball
stock	plural
upheaval	geology
accretion	geology
mylar	trademark
squid	italy
proceed	law
divestiture	law
latent	pathology
wave	physic
spam	trademark
pyramid	invest
reactive	physic
outage	computer
hold	archaism
give	slang
strait	archaism
lunge	fence
planet	astronomy
station	plural
play	game
regeneration	biology
sauce	cook
restrict	grammar
break	contract
lawrence	christianity
up	computer
telecast	television
army	military
toboggan	sport
pickup	colloquialism
dormant	biology
integrate	mathematics
positive	medicine
translate	geometry
duplex	telecommunication
galician	spain
collector	tax
sushi	japan
imam	islam
regency	england
star	astronomy
irrational	mathematics
assist	baseball
average	arithmetic
beat	cook
samurai	japanese
dial	telephone
fry	cook
in	colloquialism
activate	physic
habit	religion
spill	sail
rag	mine
echelon	military
patronage	politics
contingent	military
light	physic
terminate	contract
rally	tennis
fiddle	colloquialism
identical	physic
freeze	operation
pitch	baseball
persistent	biology
trigonometry	mathematics
tie	music
flyover	military
winchester	trademark
intrusive	geology
retail	commerce
flannel	plural
dirk	scotland
bashful	scotland
toronto	canada
raise	arithmetic
arm	military
attach	architecture
inactive	pathology
punter	football
sow	farm
link	plural
relativism	philosophy
control	science
cell	biology
communion	christianity
dedication	music
kinship	anthropology
register	boat
processor	photography
transformation	mathematics
summation	law
round	plural
sharpen	music
comet	astronomy
airhead	slang
kamikaze	japan
mosque	islam
snorkel	sport
carrier	genetics
slot	computer
thrash	farm
such	intensifier
allele	genetics
wall	anatomy
paint	art
catcher	baseball
cyclic	chemistry
pyramid	crime
paragraph	write
whisk	cook
worship	religion
build	architecture
faggot	metallurgy
wayland	europe
crap	obscenity
accommodation	physiology
midas	legend
open	chess
pluck	music
promote	chess
funky	jazz
geometry	mathematics
rib	vertebrate
modulate	music
replication	law
article	contract
deflationary	economics
assumption	christianity
ninja	japanese
splint	medicine
popular	music
tristan	legend
crest	animal
griddle	cook
net	soccer
underpants	plural
anon	colloquialism
urinalysis	medicine
crown	dentistry
babylon	mesopotamia
mountaineer	sport
passenger	bus
rampant	heraldry
syracuse	sicily
break	tennis
brother	religion
clinician	medicine
eliminate	mathematics
die	religion
replay	television
outbid	auction
forever	colloquialism
record	photography
prion	microbiology
wean	mammal
portray	art
transcription	genetics
siphon	zoology
commercialize	commerce
cyclone	meteorology
slur	music
stereophonic	electronics
tune	music
strain	psychology
easy	colloquialism
intensify	photography
pawn	commerce
quarter	military
solo	music
drink	colloquialism
kosher	judaism
crest	heraldry
stack	plural
containment	physic
raise	radio
salute	military
calisthenics	plural
wash	west
shiva	judaism
greet	plural
wilderness	virginia
sin	mesopotamia
congregational	religion
key	basketball
dramatize	write
analytic	mathematics
challenge	law
commission	military
pantheon	rome
centurion	rome
model	art
catalyze	chemistry
leo	astrology
statistician	statistic
taco	mexico
indication	medicine
tone	linguistics
believe	religion
port	ship
section	music
verdict	law
draw	art
resolve	optic
reflect	optic
intervention	law
sidebar	law
translate	physic
grail	legend
try	cook
flight	heraldry
armament	military
chaos	physic
away	baseball
poitier	france
chink	disparagement
conjunction	astronomy
proof	mathematics
shoot	colloquialism
hook	rugby
cut	squash
toe	golf
turnoff	colloquialism
catechism	politics
entitlement	law
female	biology
smorgasbord	scandinavia
threaten	plant
subgroup	mathematics
axiom	logic
vector	animal
nazi	disparagement
asset	plural
affidavit	law
annunciation	christianity
anxious	colloquialism
grind	football
hacker	terrorism
duality	geometry
camp	military
constrict	phonetics
headline	publication
manifesto	government
remainder	commerce
suit	disparagement
flatten	music
relaxation	physic
carry	livestock
translation	genetics
median	statistic
hook	box
pretrial	law
retreat	military
cohesion	physic
callus	botany
long	finance
depth	plural
eccentricity	geometry
perennial	botany
root	linguistics
traditionalism	religion
event	relativity
obviously	colloquialism
alar	biology
weather	navigation
relief	law
act	law
develop	photography
receivership	law
kill	sport
sacrifice	animal
inert	chemistry
unacceptable	linguistics
marathon	greece
notary	law
obscure	linguistics
upstage	dramaturgy
sumo	japan
leal	archaism
hot	electricity
scrum	rugby
order	architecture
inject	medicine
solicitor	law
amnesty	law
rainmaker	colloquialism
smuggle	crime
dip	physic
tag	poetry
canter	ride
nitrate	chemistry
over	cricket
traction	orthopedics
uplift	archaism
diffusion	mythology
alternate	botany
brief	law
frame	construction
snip	plural
spic	disparagement
bend	river
shore	ocean
second	music
prefecture	france
precious	intensifier
boy	disparagement
render	masonry
character	genetics
reprise	music
syncopation	music
hush	mine
finish	taste
attention	military
load	colloquialism
brig	ship
bounty	government
zodiac	astrology
badlands	plural
bishop	chess
taurus	astrology
steam	cook
acquittal	law
nebula	pathology
attachment	law
transform	biology
ensign	military
chip	golf
more	sociology
subaltern	military
groovy	colloquialism
repaint	art
bull	invest
painter	boat
leak	euphemism
moor	boat
methodist	religion
lawsuit	law
bond	dentistry
commune	switzerland
shoot	sport
troll	music
sample	telecommunication
accumulation	finance
dress	medicine
founder	ship
fredericksburg	virginia
underdevelopment	photography
commune	france
isolate	psychology
brace	plural
award	law
resistance	military
street	colloquialism
specific	pathology
sculpt	art
king	checker
reprieve	law
out	baseball
midfield	football
impression	dentistry
slice	golf
proactive	psychology
onside	sport
stoicism	philosophy
park	drive
meniscus	physic
wonderfully	intensifier
garrison	military
distal	anatomy
redemption	theology
stimulation	physiology
meter	prosody
civilization	politics
brine	cook
reduce	cook
partition	anatomy
period	trope
bogey	golf
tension	psychology
stain	microscopy
commutation	law
positively	intensifier
voodoo	haiti
grant	law
needle	sew
infiltration	military
blitz	military
play	music
connivance	law
dribble	basketball
fullerene	chemistry
medium	biology
counterattack	chess
soup	medicine
meniscus	optic
feminine	music
infielder	softball
libra	astrology
reincarnate	religion
telecommunication	plural
presentation	obstetrics
destabilization	government
osmosis	chemistry
near	comparative
tights	plural
major	music
honestly	intensifier
devolution	government
start	sport
ante	poker
appraiser	art
direct	mathematics
sign	medicine
shortstop	baseball
barrack	military
implantation	embryology
headhunter	colloquialism
active	grammar
bombard	physic
specialization	biology
herald	formality
appellate	law
digital	electronics
fill	dentistry
ensemble	art
lick	colloquialism
inventory	account
glen	scotland
creep	colloquialism
par	golf
department	france
analytic	linguistics
charge	tax
absorb	chemistry
batter	baseball
hunt	airplane
oktoberfest	germany
referee	sport
key	music
tattoo	military
field	baseball
strip	chemistry
nerve	plural
king	chess
antique	commerce
reform	chemistry
lip	botany
repulsive	physic
activate	military
deflation	geology
contain	arithmetic
thrust	geology
worse	comparative
cup	medicine
back	photography
break	meteorology
scorpio	astrology
presuppose	logic
expansive	psychiatry
wing	military
stew	cook
mission	military
limb	astronomy
hip	architecture
stabilization	aircraft
parasite	plant
minefield	military
gettysburg	pennsylvania
hustler	colloquialism
parallel	mathematics
combat	military
workaholic	blend
khalsa	sikhism
discovery	law
reduce	mathematics
roast	cook
volatile	chemistry
bel	babylon
indicative	grammar
gallop	ride
therapy	medicine
minor	law
arroyo	southwest
intention	plural
fore	seafaring
parse	grammar
involuntary	physiology
kayak	sport
whitey	slang
forward	dialect
brief	military
straight	colloquialism
carry	farm
synthetic	linguistics
enormity	colloquialism
avian	zoology
generalization	psychology
mistrial	law
pragmatism	philosophy
die	baseball
salt	cook
sortie	military
unsaturated	chemistry
script	write
hoof	slang
unregistered	boat
elf	folklore
subject	logic
spearhead	military
knit	handicraft
base	electronics
spic	slang
panel	law
linux	trademark
pickle	cook
easy	economics
shank	golf
erosion	geology
source	engineer
major	law
node	botany
paddle	sport
horn	game
pitcher	baseball
shaft	architecture
save	sport
rebel	colloquialism
aerodynamic	physic
grow	electronics
mammy	disparagement
flyover	aircraft
paternalism	government
freaky	slang
fatigue	plural
deposition	law
furnish	plural
pitcher	softball
drive	squash
bolt	politics
less	comparative
complete	football
sonnet	poetry
naturalist	zoology
together	colloquialism
reversion	law
trumpet	music
market	commerce
realtor	trademark
juke	football
series	sport
guru	buddhism
yakuza	japan
dick	colloquialism
heavy	chemistry
commander	military
induce	physic
ripple	electronics
format	computer
hinduism	india
corona	anatomy
segregation	genetics
complexion	archaism
column	architecture
aromatic	chemistry
ever	intensifier
retroactive	psychology
radical	linguistics
automatic	physiology
fault	squash
catch	baseball
nose	animal
aviation	military
rule	linguistics
vegetation	plant
agree	grammar
fence	colloquialism
fortify	cook
node	astronomy
sleeper	trope
commune	belgium
acidic	chemistry
phase	astronomy
obligate	biology
take	commerce
videotape	movie
prehistoric	colloquialism
submarine	baseball
quack	medicine
witness	law
series	mathematics
peri	persia
clean	religion
phylum	biology
dumpster	trademark
automobile	drive
capricorn	astrology
foul	baseball
sikh	sikhism
clinch	vessel
summon	law
vicksburg	mississippi
presumption	law
score	music
synchronize	movie
mahatma	hinduism
ringer	colloquialism
corner	architecture
dylan	wale
judgment	law
alienation	law
position	sport
colony	microbiology
inca	peru
best	superlative
crap	plural
blood	vertebrate
can	colloquialism
ginger	cook
counterclaim	law
commandeer	crime
light	chemistry
silo	military
dependent	grammar
people	plural
sisyphus	greece
deadly	theology
assimilate	phonetics
flour	cook
nucleus	astronomy
authority	plural
cord	plural
justify	print
offside	sport
laird	scotland
coach	sing
drawer	plural
relation	plural
drain	surgery
canine	zoology
groove	anatomy
chemist	chemistry
shore	lake
putt	golf
punt	sport
taboo	polynesia
square	colloquialism
preposition	linguistics
phylum	linguistics
effective	military
symptom	medicine
isolate	chemistry
uncharged	physic
post	bookkeeping
deconstruction	philosophy
footlights	plural
absorption	physic
constancy	psychology
demographic	statistic
complex	psychoanalysis
absorption	chemistry
debit	account
menorah	judaism
gene	genetics
cut	tennis
