seat	sit
effect	happen
ring	sound
affix	adhere
subject	experience
explode	detonate
leak	break
drug	trip
please	like
raise	rise
click	understand
pain	suffer
pall	die
flow	run
fly	float
trip	stumble
rotate	revolve
assemble	meet
ignite	burn
season	taste
ferment	sour
project	appear
flush	run
evacuate	move
give	have
low	descend
